AACG|ATA Creativity Global
AADI|Aadi Bioscience, Inc.
AADR|AdvisorShares Dorsey Wright ADR 
AAL|American Airlines Group, Inc.
AAME|Atlantic American Corporation
AAOI|Applied Optoelectronics, Inc.
AAON|AAON, Inc.
AAPB|GraniteShares
AAPL|Apple Inc.
AAXJ|iShares MSCI All Country Asia ex Japan 
ABAT|American Battery Technology Company
ABCL|AbCellera Biologics Inc.
ABCS|Alpha Blue Capital US Small
ABEO|Abeona Therapeutics Inc.
ABL|Abacus Life, Inc.
ABLLL|Abacus Life, Inc.
ABLLW|Abacus Life, Inc.
ABLV|Able View Global Inc.
ABLVW|Able View Global Inc.
ABNB|Airbnb, Inc.
ABOS|Acumen Pharmaceuticals, Inc.
ABP|Abpro Holdings, Inc
ABPWW|Abpro Holdings, Inc
ABSI|Absci Corporation
ABTS|Abits Group Inc
ABUS|Arbutus Biopharma Corporation
ABVC|ABVC BioPharma, Inc.
ABVE|Above Food Ingredients Inc.
ABVEW|Above Food Ingredients Inc.
ABVX|Abivax SA
ACAD|ACADIA Pharmaceuticals Inc.
ACB|Aurora Cannabis Inc.
ACCD|Accolade, Inc.
ACDC|ProFrac Holding Corp.
ACET|Adicet Bio, Inc.
ACGL|Arch Capital Group Ltd.
ACGLN|Arch Capital Group Ltd.
ACGLO|Arch Capital Group Ltd.
ACHC|Acadia Healthcare Company, Inc.
ACHL|Achilles Therapeutics plc
ACHV|Achieve Life Sciences, Inc.
ACIC|American Coastal Insurance Corporation
ACIU|AC Immune SA
ACIW|ACI Worldwide, Inc.
ACLS|Axcelis Technologies, Inc.
ACLX|Arcellx, Inc.
ACMR|ACM Research, Inc.
ACNB|ACNB Corporation
ACNT|Ascent Industries Co.
ACOG|Alpha Cognition Inc.
ACON|Aclarion, Inc.
ACONW|Aclarion, Inc.
ACRS|Aclaris Therapeutics, Inc.
ACRV|Acrivon Therapeutics, Inc.
ACT|Enact Holdings, Inc.
ACTG|Acacia Research Corporation
ACTU|Actuate Therapeutics, Inc.
ACVA|ACV Auctions Inc.
ACWI|iShares MSCI ACWI 
ACWX|iShares MSCI ACWI ex U.S. 
ACXP|Acurx Pharmaceuticals, Inc.
ADAG|Adagene Inc.
ADAP|Adaptimmune Therapeutics plc
ADBE|Adobe Inc.
ADD|Color Star Technology Co., Ltd.
ADEA|Adeia Inc.
ADGM|Adagio Medical Holdings, Inc
ADI|Analog Devices, Inc.
ADIL|Adial Pharmaceuticals, Inc
ADMA|ADMA Biologics Inc
ADN|Advent Technologies Holdings, Inc.
ADNWW|Advent Technologies Holdings, Inc.
ADP|Automatic Data Processing, Inc.
ADPT|Adaptive Biotechnologies Corporation
ADSE|ADS
ADSEW|ADS
ADSK|Autodesk, Inc.
ADTN|ADTRAN Holdings, Inc.
ADTX|Aditxt, Inc.
ADUR|Aduro Clean Technologies Inc.
ADUS|Addus HomeCare Corporation
ADV|Advantage Solutions Inc.
ADVM|Adverum Biotechnologies, Inc.
ADVWW|Advantage Solutions Inc.
ADXN|Addex Therapeutics Ltd
AEHL|Antelope Enterprise Holdings Limited
AEHR|Aehr Test Systems
AEI|Alset Inc.
AEIS|Advanced Energy Industries, Inc.
AEMD|Aethlon Medical, Inc.
AENT|Alliance Entertainment Holding Corporation
AENTW|Alliance Entertainment Holding Corporation
AEP|American Electric Power Company, Inc.
AERT|Aeries Technology, Inc.
AERTW|Aeries Technology, Inc.
AEYE|AudioEye, Inc.
AFBI|Affinity Bancshares, Inc.
AFCG|Advanced Flower Capital Inc.
AFJK|Aimei Health Technology Co., Ltd
AFJKR|Aimei Health Technology Co., Ltd
AFJKU|Aimei Health Technology Co., Ltd
AFMD|Affimed N.V.
AFRI|Forafric Global PLC
AFRIW|Forafric Global PLC
AFRM|Affirm Holdings, Inc.
AFYA|Afya Limited
AGAE|Allied Gaming & Entertainment Inc.
AGEN|Agenus Inc.
AGFY|Agrify Corporation
AGIO|Agios Pharmaceuticals, Inc.
AGIX|KraneShares Artificial Intelligence & Technology 
AGMH|AGM Group Holdings Inc.
AGMI|Themes Silver Miners 
AGNC|AGNC Investment Corp.
AGNCL|AGNC Investment Corp.
AGNCM|AGNC Investment Corp.
AGNCN|AGNC Investment Corp.
AGNCO|AGNC Investment Corp.
AGNCP|AGNC Investment Corp.
AGNG|Global X Aging Population 
AGRI|AgriFORCE  Growing Systems Ltd.
AGYS|Agilysys, Inc.
AGZD|WisdomTree Interest Rate Hedged U.S. Aggregate Bond Fund
AHCO|AdaptHealth Corp.
AHG|Akso Health Group
AIA|iShares Asia 50 
AIEV|Thunder Power Holdings, Inc.
AIFF|Firefly Neuroscience, Inc.
AIFU|AIX Inc.
AIHS|Senmiao Technology Limited
AILE|iLearningEngines, Inc.
AILEW|iLearningEngines, Inc.
AIMAU|Aimfinity Investment Corp. I
AIMAW|Aimfinity Investment Corp. I
AIMBU|Aimfinity Investment Corp. I
AIMD|Ainos, Inc.
AIMDW|Ainos, Inc.
AIOT|PowerFleet, Inc.
AIP|Arteris, Inc.
AIPI|REX AI Equity Premium Income 
AIQ|Global X Artificial Intelligence & Technology 
AIRE|reAlpha Tech Corp.
AIRG|Airgain, Inc.
AIRJ|AirJoule Technologies Corporation
AIRJW|AirJoule Technologies Corporation
AIRL|Themes Airlines 
AIRR|First Trust RBA American Industrial Renaissance 
AIRS|AirSculpt Technologies, Inc.
AIRT|Air T, Inc.
AIRTP|Air T, Inc.
AISP|Airship AI Holdings, Inc
AISPW|Airship AI Holdings, Inc
AITR|AI TRANSPORTATION ACQUISITION CORP
AITRR|AI TRANSPORTATION ACQUISITION CORP
AITRU|AI TRANSPORTATION ACQUISITION CORP
AIXI|XIAO
AKAM|Akamai Technologies, Inc.
AKAN|Akanda Corp.
AKBA|Akebia Therapeutics, Inc.
AKRO|Akero Therapeutics, Inc.
AKTS|Akoustis Technologies, Inc.
AKTX|Akari Therapeutics Plc
AKYA|Akoya BioSciences, Inc.
ALAB|Astera Labs, Inc.
ALAR|Alarum Technologies Ltd.
ALBT|Avalon GloboCare Corp.
ALCE|Alternus Clean Energy, Inc.
ALCO|Alico, Inc.
ALCY|Alchemy Investments Acquisition Corp 1
ALCYU|Alchemy Investments Acquisition Corp 1
ALCYW|Alchemy Investments Acquisition Corp 1
ALDFU|Aldel Financial II Inc.
ALDX|Aldeyra Therapeutics, Inc.
ALEC|Alector, Inc.
ALF|Centurion Acquisition Corp.
ALFUU|Centurion Acquisition Corp.
ALFUW|Centurion Acquisition Corp.
ALGM|Allegro MicroSystems, Inc.
ALGN|Align Technology, Inc.
ALGS|Aligos Therapeutics, Inc.
ALGT|Allegiant Travel Company
ALHC|Alignment Healthcare, Inc.
ALKS|Alkermes plc
ALKT|Alkami Technology, Inc.
ALLK|Allakos Inc.
ALLO|Allogene Therapeutics, Inc.
ALLR|Allarity Therapeutics, Inc.
ALLT|Allot Ltd.
ALMS|Alumis Inc.
ALNT|Allient Inc.
ALNY|Alnylam Pharmaceuticals, Inc.
ALOT|AstroNova, Inc.
ALRM|Alarm.com Holdings, Inc.
ALRN|Aileron Therapeutics, Inc.
ALRS|Alerus Financial Corporation
ALSA|Alpha Star Acquisition Corporation
ALSAR|Alpha Star Acquisition Corporation
ALSAU|Alpha Star Acquisition Corporation
ALSAW|Alpha Star Acquisition Corporation
ALT|Altimmune, Inc.
ALTI|AlTi Global, Inc.
ALTO|Alto Ingredients, Inc.
ALTR|Altair Engineering Inc.
ALTS|ALT5 Sigma Corporation
ALTY|Global X Alternative Income 
ALVO|Alvotech
ALVOW|Alvotech
ALVR|AlloVir, Inc.
ALXO|ALX Oncology Holdings Inc.
ALZN|Alzamend Neuro, Inc.
AMAL|Amalgamated Financial Corp.
AMAT|Applied Materials, Inc.
AMBA|Ambarella, Inc.
AMCX|AMC Networks Inc.
AMD|Advanced Micro Devices, Inc.
AMDL|GraniteShares  Long AMD Daily 
AMDS|GraniteShares  Short AMD Daily 
AMED|Amedisys Inc
AMGN|Amgen Inc.
AMID|Argent Mid Cap 
AMIX|Autonomix Medical, Inc.
AMKR|Amkor Technology, Inc.
AMLI|American Lithium Corp.
AMLX|Amylyx Pharmaceuticals, Inc.
AMPG|Amplitech Group, Inc.
AMPGW|Amplitech Group, Inc.
AMPH|Amphastar Pharmaceuticals, Inc.
AMPL|Amplitude, Inc.
AMRK|A
AMRN|Amarin Corporation plc
AMRX|Amneal Pharmaceuticals, Inc.
AMSC|American Superconductor Corporation
AMSF|AMERISAFE, Inc.
AMST|Amesite Inc.
AMTX|Aemetis, Inc
AMWD|American Woodmark Corporation
AMZN|Amazon.com, Inc.
AMZZ|GraniteShares  Long AMZN Daily 
ANAB|AnaptysBio, Inc.
ANDE|The Andersons, Inc.
ANEB|Anebulo Pharmaceuticals, Inc.
ANGH|Anghami Inc.
ANGHW|Anghami Inc.
ANGI|Angi Inc.
ANGO|AngioDynamics, Inc.
ANIK|Anika Therapeutics Inc.
ANIP|ANI Pharmaceuticals, Inc.
ANIX|Anixa Biosciences, Inc.
ANL|Adlai Nortye Ltd.
ANNX|Annexon, Inc.
ANSC|Agriculture & Natural Solutions Acquisition Corporation
ANSCU|Agriculture & Natural Solutions Acquisition Corporation
ANSCW|Agriculture & Natural Solutions Acquisition Corporation
ANSS|ANSYS, Inc.
ANTE|AirNet Technology Inc.
ANTX|AN2 Therapeutics, Inc.
ANY|Sphere 3D Corp.
AOSL|Alpha and Omega Semiconductor Limited
AOTG|AOT Growth and Innovation 
AOUT|American Outdoor Brands, Inc.
APA|APA Corporation
APCX|AppTech Payments Corp.
APCXW|AppTech Payments Corp.
APDN|Applied DNA Sciences, Inc.
APEI|American Public Education, Inc.
APGE|Apogee Therapeutics, Inc.
API|Agora, Inc.
APLD|Applied Digital Corporation
APLM|Apollomics Inc.
APLMW|Apollomics Inc.
APLS|Apellis Pharmaceuticals, Inc.
APLT|Applied Therapeutics, Inc.
APM|Aptorum Group Limited
APOG|Apogee Enterprises, Inc.
APP|Applovin Corporation
APPF|AppFolio, Inc.
APPN|Appian Corporation
APPS|Digital Turbine, Inc.
APRE|Aprea Therapeutics, Inc.
APTO|Aptose Biosciences, Inc.
APVO|Aptevo Therapeutics Inc.
APWC|Asia Pacific Wire & Cable Corporation Limited
APXI|APx Acquisition Corp. I
APYX|Apyx Medical Corporation
AQB|AquaBounty Technologies, Inc.
AQMS|Aqua Metals, Inc.
AQST|Aquestive Therapeutics, Inc.
AQU|Aquaron Acquisition Corp.
AQUNR|Aquaron Acquisition Corp.
AQUNU|Aquaron Acquisition Corp.
AQWA|Global X Clean Water 
ARAY|Accuray Incorporated
ARBB|ARB IOT Group Limited
ARBE|Arbe Robotics Ltd.
ARBEW|Arbe Robotics Ltd.
ARBK|Argo Blockchain plc
ARBKL|Argo Blockchain plc
ARCB|ArcBest Corporation
ARCC|Ares Capital Corporation
ARCT|Arcturus Therapeutics Holdings Inc.
ARDX|Ardelyx, Inc.
AREB|American Rebel Holdings, Inc.
AREBW|American Rebel Holdings, Inc.
AREC|American Resources Corporation
ARGX|argenx SE
ARHS|Arhaus, Inc.
ARKO|ARKO Corp.
ARKOW|ARKO Corp.
ARKR|Ark Restaurants Corp.
ARLP|Alliance Resource Partners, L.P.
ARM|Arm Holdings plc
AROW|Arrow Financial Corporation
ARQ|Arq, Inc.
ARQQ|Arqit Quantum Inc.
ARQQW|Arqit Quantum Inc.
ARQT|Arcutis Biotherapeutics, Inc.
ARRY|Array Technologies, Inc.
ARTL|Artelo Biosciences, Inc.
ARTNA|Artesian Resources Corporation
ARTV|Artiva Biotherapeutics, Inc.
ARTW|Art's
ARVN|Arvinas, Inc.
ARVR|First Trust Indxx Metaverse 
ARWR|Arrowhead Pharmaceuticals, Inc.
ASET|FlexShares Real Assets Allocation Index Fund
ASLE|AerSale Corporation
ASMB|Assembly Biosciences, Inc.
ASML|ASML Holding N.V.
ASND|Ascendis Pharma A/S
ASNS|Actelis Networks, Inc.
ASO|Academy Sports and Outdoors, Inc.
ASPCU|A SPAC III Acquisition Corp.
ASPI|ASP Isotopes Inc.
ASPS|Altisource Portfolio Solutions S.A.
ASRT|Assertio Holdings, Inc.
ASRV|AmeriServ Financial Inc.
ASST|Asset Entities Inc.
ASTC|Astrotech Corporation
ASTE|Astec Industries, Inc.
ASTH|Astrana Health Inc.
ASTI|Ascent Solar Technologies, Inc
ASTL|Algoma Steel Group Inc.
ASTLW|Algoma Steel Group Inc.
ASTS|AST SpaceMobile, Inc.
ASUR|Asure Software Inc
ASYS|Amtech Systems, Inc.
ATAI|ATAI Life Sciences N.V.
ATAT|Atour Lifestyle Holdings Limited
ATCOL|Atlas Corp.
ATEC|Alphatec Holdings, Inc.
ATER|Aterian, Inc.
ATEX|Anterix Inc.
ATGL|Alpha Technology Group Limited
ATHA|Athira Pharma, Inc.
ATHE|Alterity Therapeutics Limited
ATIF|ATIF Holdings Limited
ATLC|Atlanticus Holdings Corporation
ATLCL|Atlanticus Holdings Corporation
ATLCP|Atlanticus Holdings Corporation
ATLCZ|Atlanticus Holdings Corporation
ATLO|Ames National Corporation
ATLX|Atlas Lithium Corporation
ATMC|AlphaTime Acquisition Corp
ATMCR|AlphaTime Acquisition Corp
ATMCU|AlphaTime Acquisition Corp
ATMCW|AlphaTime Acquisition Corp
ATMV|AlphaVest Acquisition Corp
ATMVR|AlphaVest Acquisition Corp
ATMVU|AlphaVest Acquisition Corp
ATNF|180 Life Sciences Corp.
ATNFW|180 Life Sciences Corp.
ATNI|ATN International, Inc.
ATOM|Atomera Incorporated
ATOS|Atossa Therapeutics, Inc.
ATPC|Agape ATP Corporation
ATRA|Atara Biotherapeutics, Inc.
ATRC|AtriCure, Inc.
ATRO|Astronics Corporation
ATSG|Air Transport Services Group, Inc
ATXG|Addentax Group Corp.
ATXI|Avenue Therapeutics, Inc.
ATXS|Astria Therapeutics, Inc.
ATYR|aTyr Pharma, Inc.
AUBN|Auburn National Bancorporation, Inc.
AUDC|AudioCodes Ltd.
AUID|authID Inc.
AUMI|Themes Gold Miners 
AUPH|Aurinia Pharmaceuticals Inc
AUR|Aurora Innovation, Inc.
AURA|Aura Biosciences, Inc.
AUROW|Aurora Innovation, Inc.
AUTL|Autolus Therapeutics plc
AUUD|Auddia Inc.
AUUDW|Auddia Inc.
AVAH|Aveanna Healthcare Holdings Inc.
AVAV|AeroVironment, Inc.
AVBP|ArriVent BioPharma, Inc.
AVDL|Avadel Pharmaceuticals plc
AVDX|AvidXchange Holdings, Inc.
AVGO|Broadcom Inc.
AVGR|Avinger, Inc.
AVGX|Defiance Daily Target  Long AVGO 
AVIR|Atea Pharmaceuticals, Inc.
AVNW|Aviat Networks, Inc.
AVO|Mission Produce, Inc.
AVPT|AvePoint, Inc.
AVPTW|AvePoint, Inc.
AVT|Avnet, Inc.
AVTE|Aerovate Therapeutics, Inc.
AVTX|Avalo Therapeutics, Inc.
AVXC|Avantis Emerging Markets ex
AVXL|Anavex Life Sciences Corp.
AWH|Aspira Women's Health Inc.
AWRE|Aware, Inc.
AXDX|Accelerate Diagnostics, Inc.
AXGN|Axogen, Inc.
AXON|Axon Enterprise, Inc.
AXSM|Axsome Therapeutics, Inc.
AXTI|AXT Inc
AY|Atlantica Sustainable Infrastructure plc
AYRO|AYRO, Inc.
AYTU|Aytu BioPharma, Inc.
AZ|A2Z Cust2Mate Solutions Corp.
AZI|Autozi Internet Technology (Global) Ltd.
AZN|AstraZeneca PLC
AZPN|Aspen Technology, Inc.
AZTA|Azenta, Inc.
BABX|GraniteShares  Long BABA Daily 
BACK|IMAC Holdings, Inc.
BACQU|Bleichroeder Acquisition Corp. I
BAER|Bridger Aerospace Group Holdings, Inc.
BAERW|Bridger Aerospace Group Holdings, Inc.
BAFE|Brown Advisory Flexible Equity 
BAFN|BayFirst Financial Corp.
BAND|Bandwidth Inc.
BANF|BancFirst Corporation
BANFP|BancFirst Corporation
BANL|CBL International Limited
BANR|Banner Corporation
BANX|ArrowMark Financial Corp.
BAOS|Baosheng Media Group Holdings Limited
BASE|Couchbase, Inc.
BATRA|Atlanta Braves Holdings, Inc.
BATRK|Atlanta Braves Holdings, Inc.
BAYA|Bayview Acquisition Corp
BAYAR|Bayview Acquisition Corp
BAYAU|Bayview Acquisition Corp
BBCP|Concrete Pumping Holdings, Inc.
BBGI|Beasley Broadcast Group, Inc.
BBH|VanEck Biotech 
BBIO|BridgeBio Pharma, Inc.
BBLG|Bone Biologics Corp
BBLGW|Bone Biologics Corp
BBSI|Barrett Business Services, Inc.
BCAB|BioAtla, Inc.
BCAL|California BanCorp
BCAN|Femto Technologies Inc.
BCAX|Bicara Therapeutics Inc.
BCBP|BCB Bancorp, Inc. (NJ)
BCDA|BioCardia, Inc.
BCG|Binah Capital Group, Inc.
BCGWW|Binah Capital Group, Inc.
BCLI|Brainstorm Cell Therapeutics Inc.
BCML|BayCom Corp
BCOV|Brightcove Inc.
BCOW|1895 Bancorp of Wisconsin, Inc.
BCPC|Balchem Corporation
BCRX|BioCryst Pharmaceuticals, Inc.
BCTX|BriaCell Therapeutics Corp.
BCTXW|BriaCell Therapeutics Corp.
BCYC|Bicycle Therapeutics plc
BDGS|Bridges Capital Tactical 
BDMD|Baird Medical Investment Holdings Ltd
BDMDW|Baird Medical Investment Holdings Ltd
BDRX|Biodexa Pharmaceuticals plc
BDSX|Biodesix, Inc.
BDTX|Black Diamond Therapeutics, Inc.
BEAGU|Bold Eagle Acquisition Corp.
BEAM|Beam Therapeutics Inc.
BEAT|Heartbeam, Inc.
BEATW|Heartbeam, Inc.
BECN|Beacon Roofing Supply, Inc.
BEEM|Beam Global
BEEZ|Honeytree U.S. Equity 
BELFA|Bel Fuse Inc.
BELFB|Bel Fuse Inc.
BELT|iShares Long
BENF|Beneficient
BENFW|Beneficient
BETR|Better Home
BETRW|Better Home
BFC|Bank First Corporation
BFIN|BankFinancial Corporation
BFRG|Bullfrog AI Holdings, Inc.
BFRGW|Bullfrog AI Holdings, Inc.
BFRI|Biofrontera Inc.
BFRIW|Biofrontera Inc.
BFST|Business First Bancshares, Inc.
BGC|BGC Group, Inc.
BGFV|Big 5 Sporting Goods Corporation
BGLC|BioNexus Gene Lab Corp
BGM|BGM Group Ltd.
BGNE|BeiGene, Ltd.
BGRN|iShares USD Green Bond 
BGRO|iShares Large Cap Growth Active 
BHAT|Blue Hat Interactive Entertainment Technology
BHF|Brighthouse Financial, Inc.
BHFAL|Brighthouse Financial, Inc.
BHFAM|Brighthouse Financial, Inc.
BHFAN|Brighthouse Financial, Inc.
BHFAO|Brighthouse Financial, Inc.
BHFAP|Brighthouse Financial, Inc.
BHIL|Benson Hill, Inc.
BHRB|Burke & Herbert Financial Services Corp.
BHST|BioHarvest Sciences Inc.
BIAF|bioAffinity Technologies, Inc.
BIAFW|bioAffinity Technologies, Inc.
BIB|ProShares Ultra Nasdaq Biotechnology
BIDU|Baidu, Inc.
BIGC|BigCommerce Holdings, Inc.
BIIB|Biogen Inc.
BILI|Bilibili Inc.
BIOA|BioAge Labs, Inc.
BIOR|Biora Therapeutics, Inc.
BIOX|Bioceres Crop Solutions Corp.
BIRD|Allbirds, Inc.
BIS|ProShares UltraShort Nasdaq Biotechnology
BITF|Bitfarms Ltd.
BITS|Global X Blockchain & Bitcoin Strategy 
BIVI|BioVie Inc.
BJDX|Bluejay Diagnostics, Inc.
BJK|VanEck Gaming 
BJRI|BJ's Restaurants, Inc.
BKCH|Global X Blockchain 
BKHA|Black Hawk Acquisition Corporation
BKHAR|Black Hawk Acquisition Corporation
BKHAU|Black Hawk Acquisition Corporation
BKIV|BNY Mellon Innovators 
BKNG|Booking Holdings Inc.
BKR|Baker Hughes Company
BKWO|BNY Mellon Women's Opportunities 
BKYI|BIO
BL|BlackLine, Inc.
BLAC|Bellevue Life Sciences Acquisition Corp.
BLACR|Bellevue Life Sciences Acquisition Corp.
BLACU|Bellevue Life Sciences Acquisition Corp.
BLACW|Bellevue Life Sciences Acquisition Corp.
BLBD|Blue Bird Corporation
BLBX|Blackboxstocks Inc.
BLCN|Siren Nasdaq NexGen Economy 
BLCR|iShares Large Cap Core Active 
BLDE|Blade Air Mobility, Inc.
BLDEW|Blade Air Mobility, Inc.
BLDP|Ballard Power Systems, Inc.
BLEU|bleuacacia ltd
BLEUR|bleuacacia ltd
BLEUU|bleuacacia ltd
BLEUW|bleuacacia ltd
BLFS|BioLife Solutions, Inc.
BLFY|Blue Foundry Bancorp
BLIN|Bridgeline Digital, Inc.
BLKB|Blackbaud, Inc.
BLLD|JPMorgan Sustainable Infrastructure 
BLMN|Bloomin' Brands, Inc.
BLMZ|BloomZ Inc.
BLNK|Blink Charging Co.
BLRX|BioLineRx Ltd.
BLTE|Belite Bio, Inc
BLUE|bluebird bio, Inc.
BLZE|Backblaze, Inc.
BMBL|Bumble Inc.
BMEA|Biomea Fusion, Inc.
BMR|Beamr Imaging Ltd.
BMRA|Biomerica, Inc.
BMRC|Bank of Marin Bancorp
BMRN|BioMarin Pharmaceutical Inc.
BNAI|Brand Engagement Network Inc.
BNAIW|Brand Engagement Network Inc.
BND|Vanguard Total Bond Market
BNGO|Bionano Genomics, Inc.
BNIX|Bannix Acquisition Corp.
BNIXR|Bannix Acquisition Corp.
BNIXW|Bannix Acquisition Corp.
BNOX|Bionomics Limited
BNR|Burning Rock Biotech Limited
BNRG|Brenmiller Energy Ltd
BNTC|Benitec Biopharma Inc.
BNTX|BioNTech SE
BNZI|Banzai International, Inc.
BNZIW|Banzai International, Inc.
BOCN|Blue Ocean Acquisition Corp
BOCNU|Blue Ocean Acquisition Corp
BOCNW|Blue Ocean Acquisition Corp
BOF|BranchOut Food Inc.
BOKF|BOK Financial Corporation
BOLD|Boundless Bio, Inc.
BOLT|Bolt Biotherapeutics, Inc.
BON|Bon Natural Life Limited
BOOM|DMC Global Inc.
BOSC|B.O.S. Better Online Solutions
BOTJ|Bank of the James Financial Group, Inc.
BOTT|Themes Robotics & Automation 
BOTZ|Global X Robotics & Artificial Intelligence 
BOWN|Bowen Acquisition Corp
BOWNR|Bowen Acquisition Corp
BOWNU|Bowen Acquisition Corp
BOXL|Boxlight Corporation
BPMC|Blueprint Medicines Corporation
BPOP|Popular, Inc.
BPOPM|Popular, Inc.
BPRN|Princeton Bancorp, Inc.
BPTH|Bio
BPYPM|Brookfield Property Partners L.P.
BPYPN|Brookfield Property Partners L.P.
BPYPO|Brookfield Property Partners L.P.
BPYPP|Brookfield Property Partners L.P.
BRAC|Broad Capital Acquisition Corp
BRACR|Broad Capital Acquisition Corp
BRACU|Broad Capital Acquisition Corp
BRAG|Bragg Gaming Group Inc.
BREA|Brera Holdings PLC
BRFH|Barfresh Food Group Inc.
BRHY|iShares High Yield Active 
BRID|Bridgford Foods Corporation
BRKH|BurTech Acquisition Corp.
BRKHU|BurTech Acquisition Corp.
BRKHW|BurTech Acquisition Corp.
BRKL|Brookline Bancorp, Inc.
BRKR|Bruker Corporation
BRLS|Borealis Foods Inc.
BRLSW|Borealis Foods Inc.
BRLT|Brilliant Earth Group, Inc.
BRNS|Barinthus Biotherapeutics plc
BRNY|Burney U.S. Factor Rotation 
BROG|Brooge Energy Limited
BROGW|Brooge Energy Limited
BRRR|Coinshares Valkyrie Bitcoin Fund
BRTR|iShares Total Return Active 
BRTX|BioRestorative Therapies, Inc.
BRY|Berry Corporation (bry)
BRZE|Braze, Inc.
BSBK|Bogota Financial Corp.
BSET|Bassett Furniture Industries, Incorporated
BSFC|Blue Star Foods Corp.
BSGM|BioSig Technologies, Inc.
BSII|Black Spade Acquisition II Co
BSIIU|Black Spade Acquisition II Co
BSIIW|Black Spade Acquisition II Co
BSLK|Bolt Projects Holdings, Inc.
BSLKW|Bolt Projects Holdings, Inc.
BSRR|Sierra Bancorp
BSVN|Bank7 Corp.
BSVO|EA Bridgeway Omni Small
BSY|Bentley Systems, Incorporated
BTAI|BioXcel Therapeutics, Inc.
BTBD|BT Brands, Inc.
BTBDW|BT Brands, Inc.
BTBT|Bit Digital, Inc.
BTCS|BTCS Inc.
BTCT|BTC Digital Ltd.
BTCTW|BTC Digital Ltd.
BTDR|Bitdeer Technologies Group
BTF|CoinShares Valkyrie Bitcoin and Ether Strategy 
BTFX|CoinShares Valkyrie Bitcoin Futures Leveraged Strategy 
BTGD|STKD Bitcoin & Gold 
BTM|Bitcoin Depot Inc.
BTMD|Biote Corp.
BTMWW|Bitcoin Depot Inc.
BTOC|Armlogi Holding Corp.
BTOG|Bit Origin Limited
BTSG|BrightSpring Health Services, Inc.
BTSGU|BrightSpring Health Services, Inc.
BUFC|AB Conservative Buffer 
BUG|Global X Cybersecurity 
BUJA|Bukit Jalil Global Acquisition 1 Ltd.
BUJAR|Bukit Jalil Global Acquisition 1 Ltd.
BUJAU|Bukit Jalil Global Acquisition 1 Ltd.
BUJAW|Bukit Jalil Global Acquisition 1 Ltd.
BULD|Pacer BlueStar Engineering the Future 
BUSE|First Busey Corporation
BVFL|BV Financial, Inc.
BVS|Bioventus Inc.
BWAY|BrainsWay Ltd.
BWB|Bridgewater Bancshares, Inc.
BWBBP|Bridgewater Bancshares, Inc.
BWEN|Broadwind, Inc.
BWFG|Bankwell Financial Group, Inc.
BWIN|The Baldwin Insurance Group, Inc.
BWMN|Bowman Consulting Group Ltd.
BYFC|Broadway Financial Corporation
BYND|Beyond Meat, Inc.
BYNO|byNordic Acquisition Corporation
BYNOU|byNordic Acquisition Corporation
BYNOW|byNordic Acquisition Corporation
BYRN|Byrna Technologies, Inc.
BYSI|BeyondSpring, Inc.
BZ|KANZHUN LIMITED
BZFD|BuzzFeed, Inc.
BZFDW|BuzzFeed, Inc.
BZUN|Baozun Inc.
CA|Xtrackers California Municipal Bonds 
CAAS|China Automotive Systems, Inc.
CABA|Cabaletta Bio, Inc.
CAC|Camden National Corporation
CACC|Credit Acceptance Corporation
CADL|Candel Therapeutics, Inc.
CAFG|Pacer US Small Cap Cash Cows Growth Leaders 
CAKE|The Cheesecake Factory Incorporated
CALC|CalciMedica, Inc.
CALI|iShares Short
CALM|Cal
CAMP|CAMP4 Therapeutics Corporation
CAMT|Camtek Ltd.
CAN|Canaan Inc.
CANC|Tema Oncology 
CANQ|Calamos Alternative Nasdaq & Bond 
CAPN|Cayson Acquisition Corp
CAPNR|Cayson Acquisition Corp
CAPNU|Cayson Acquisition Corp
CAPR|Capricor Therapeutics, Inc.
CAPT|Captivision Inc.
CAPTW|Captivision Inc.
CAR|Avis Budget Group, Inc.
CARA|Cara Therapeutics, Inc.
CARE|Carter Bankshares, Inc.
CARG|CarGurus, Inc.
CARM|Carisma Therapeutics, Inc.
CART|Maplebear Inc.
CARV|Carver Bancorp, Inc.
CARZ|First Trust S-Network Electric & Future Vehicle Ecosystem
CASH|Pathward Financial, Inc.
CASI|CASI Pharmaceuticals, Inc.
CASK|Heritage Distilling Holding Company, Inc.
CASS|Cass Information Systems, Inc
CASY|Caseys General Stores, Inc.
CATH|Global X S&P 500 Catholic Values 
CATY|Cathay General Bancorp
CBAT|CBAK Energy Technology, Inc.
CBFV|CB Financial Services, Inc.
CBLL|CeriBell, Inc.
CBNK|Capital Bancorp, Inc.
CBRL|Cracker Barrel Old Country Store, Inc.
CBSH|Commerce Bancshares, Inc.
CBUS|Cibus, Inc.
CCAP|Crescent Capital BDC, Inc.
CCB|Coastal Financial Corporation
CCBG|Capital City Bank Group
CCCC|C4 Therapeutics, Inc.
CCCS|CCC Intelligent Solutions Holdings Inc.
CCD|Calamos Dynamic Convertible & Income Fund
CCEC|Capital Clean Energy Carriers Corp.
CCEP|Coca
CCG|Cheche Group Inc.
CCGWW|Cheche Group Inc.
CCIRU|Cohen Circle Acquisition Corp. I
CCIX|Churchill Capital Corp IX
CCIXU|Churchill Capital Corp IX
CCIXW|Churchill Capital Corp IX
CCLD|CareCloud, Inc.
CCLDO|CareCloud, Inc.
CCLDP|CareCloud, Inc.
CCNE|CNB Financial Corporation
CCNEP|CNB Financial Corporation
CCNR|ALPS/CoreCommodity Natural Resources 
CCOI|Cogent Communications Holdings, Inc.
CCRN|Cross Country Healthcare, Inc.
CCSB|Carbon Collective Short Duration Green Bond 
CCSI|Consensus Cloud Solutions, Inc.
CCSO|Carbon Collective Climate Solutions U.S. Equity 
CCTG|CCSC Technology International Holdings Limited
CDC|VictoryShares US EQ Income Enhanced Volatility Wtd 
CDIO|Cardio Diagnostics Holdings Inc.
CDIOW|Cardio Diagnostics Holdings Inc.
CDL|VictoryShares US Large Cap High Div Volatility Wtd 
CDLX|Cardlytics, Inc.
CDMO|Avid Bioservices, Inc.
CDNA|CareDx, Inc.
CDNS|Cadence Design Systems, Inc.
CDRO|Codere Online Luxembourg, S.A.
CDROW|Codere Online Luxembourg, S.A.
CDT|Conduit Pharmaceuticals Inc.
CDTG|CDT Environmental Technology Investment Holdings Limited
CDTTW|Conduit Pharmaceuticals Inc.
CDTX|Cidara Therapeutics, Inc.
CDW|CDW Corporation
CDXC|ChromaDex Corporation
CDXS|Codexis, Inc.
CDZI|Cadiz, Inc.
CDZIP|Cadiz, Inc.
CEAD|CEA Industries Inc.
CEADW|CEA Industries Inc.
CECO|CECO Environmental Corp.
CEFA|Global X S&P Catholic Values Developed ex
CEG|Constellation Energy Corporation
CELC|Celcuity Inc.
CELH|Celsius Holdings, Inc.
CELU|Celularity Inc.
CELUW|Celularity Inc.
CELZ|Creative Medical Technology Holdings, Inc.
CENN|Cenntro Inc.
CENT|Central Garden & Pet Company
CENTA|Central Garden & Pet Company
CENX|Century Aluminum Company
CEP|Cantor Equity Partners, Inc.
CERO|CERo Therapeutics Holdings, Inc.
CEROW|CERo Therapeutics Holdings, Inc.
CERS|Cerus Corporation
CERT|Certara, Inc.
CETX|Cemtrex Inc.
CETY|Clean Energy Technologies, Inc.
CEVA|CEVA, Inc.
CFA|VictoryShares US 500 Volatility Wtd 
CFB|CrossFirst Bankshares, Inc.
CFBK|CF Bankshares Inc.
CFFI|C&F Financial Corporation
CFFN|Capitol Federal Financial, Inc.
CFFS|CF Acquisition Corp. VII
CFFSU|CF Acquisition Corp. VII
CFFSW|CF Acquisition Corp. VII
CFLT|Confluent, Inc.
CFO|VictoryShares US 500 Enhanced Volatility Wtd 
CFSB|CFSB Bancorp, Inc.
CG|The Carlyle Group Inc.
CGABL|The Carlyle Group Inc.
CGBD|Carlyle Secured Lending, Inc.
CGBDL|Carlyle Secured Lending, Inc.
CGBS|Crown LNG Holdings Limited
CGBSW|Crown LNG Holdings Limited
CGC|Canopy Growth Corporation
CGEM|Cullinan Therapeutics, Inc.
CGEN|Compugen Ltd.
CGNT|Cognyte Software Ltd.
CGNX|Cognex Corporation
CGO|Calamos Global Total Return Fund
CGON|CG Oncology, Inc.
CGTX|Cognition Therapeutics, Inc.
CHARU|Charlton Aria Acquisition Corporation
CHCI|Comstock Holding Companies, Inc.
CHCO|City Holding Company
CHDN|Churchill Downs, Incorporated
CHEF|The Chefs' Warehouse, Inc.
CHEK|Check
CHI|Calamos Convertible Opportunities and Income Fund
CHKP|Check Point Software Technologies Ltd.
CHMG|Chemung Financial Corp
CHNR|China Natural Resources, Inc.
CHPS|Xtrackers Semiconductor Select Equity 
CHR|Cheer Holding, Inc.
CHRD|Chord Energy Corporation
CHRS|Coherus BioSciences, Inc.
CHRW|C.H. Robinson Worldwide, Inc.
CHSCL|CHS Inc
CHSCM|CHS Inc
CHSCN|CHS Inc
CHSCO|CHS Inc
CHSCP|CHS Inc
CHSN|Chanson International Holding
CHTR|Charter Communications, Inc.
CHW|Calamos Global Dynamic Income Fund
CHX|ChampionX Corporation
CHY|Calamos Convertible and High Income Fund
CIBR|First Trust NASDAQ Cybersecurity 
CIFR|Cipher Mining Inc.
CIFRW|Cipher Mining Inc.
CIGI|Colliers International Group Inc.
CIL|VictoryShares International Volatility Wtd 
CINF|Cincinnati Financial Corporation
CING|Cingulate Inc.
CINGW|Cingulate Inc.
CISO|CISO Global, Inc.
CISS|C3is Inc.
CITE|Cartica Acquisition Corp
CITEU|Cartica Acquisition Corp
CITEW|Cartica Acquisition Corp
CIVB|Civista Bancshares, Inc.
CJET|Chijet Motor Company, Inc.
CJJD|China Jo
CKPT|Checkpoint Therapeutics, Inc.
CLAR|Clarus Corporation
CLBK|Columbia Financial, Inc.
CLBT|Cellebrite DI Ltd.
CLDX|Celldex Therapeutics, Inc.
CLEU|China Liberal Education Holdings Limited
CLFD|Clearfield, Inc.
CLGN|CollPlant Biotechnologies Ltd.
CLIK|Click Holdings Limited
CLIR|ClearSign Technologies Corporation
CLLS|Cellectis S.A.
CLMB|Climb Global Solutions, Inc.
CLMT|Calumet, Inc
CLNE|Clean Energy Fuels Corp.
CLNN|Clene Inc.
CLNNW|Clene Inc.
CLOA|iShares AAA CLO Active 
CLOD|Themes Cloud Computing 
CLOU|Global X Cloud Computing 
CLOV|Clover Health Investments, Corp.
CLPS|CLPS Incorporation
CLPT|ClearPoint Neuro Inc.
CLRB|Cellectar Biosciences, Inc.
CLRC|ClimateRock
CLRCR|ClimateRock
CLRCU|ClimateRock
CLRCW|ClimateRock
CLRO|ClearOne, Inc.
CLSD|Clearside Biomedical, Inc.
CLSK|CleanSpark, Inc.
CLSKW|CleanSpark, Inc.
CLSM|Cabana Target Leading Sector Moderate 
CLST|Catalyst Bancorp, Inc.
CLWT|Euro Tech Holdings Company Limited
CLYM|Climb Bio, Inc.
CMAX|CareMax, Inc.
CMAXW|CareMax, Inc.
CMBM|Cambium Networks Corporation
CMCO|Columbus McKinnon Corporation
CMCSA|Comcast Corporation
CMCT|Creative Media & Community Trust Corporation
CME|CME Group Inc.
CMLS|Cumulus Media Inc.
CMMB|Chemomab Therapeutics Ltd.
CMND|Clearmind Medicine Inc.
CMPO|CompoSecure, Inc.
CMPOW|CompoSecure, Inc.
CMPR|Cimpress plc
CMPS|COMPASS Pathways Plc
CMPX|Compass Therapeutics, Inc.
CMRX|Chimerix, Inc.
CMTL|Comtech Telecommunications Corp.
CNCR|Range Cancer Therapeutics 
CNDT|Conduent Incorporated
CNET|ZW Data Action Technologies Inc.
CNEY|CN Energy Group Inc.
CNFR|Conifer Holdings, Inc.
CNFRZ|Conifer Holdings, Inc.
CNOB|ConnectOne Bancorp, Inc.
CNOBP|ConnectOne Bancorp, Inc.
CNSL|Consolidated Communications Holdings, Inc.
CNSP|CNS Pharmaceuticals, Inc.
CNTA|Centessa Pharmaceuticals plc
CNTB|Connect Biopharma Holdings Limited
CNTM|ConnectM Technology Solutions, Inc.
CNTX|Context Therapeutics Inc.
CNTY|Century Casinos, Inc.
CNVS|Cineverse Corp.
CNXC|Concentrix Corporation
CNXN|PC Connection, Inc.
COCH|Envoy Medical, Inc.
COCHW|Envoy Medical, Inc.
COCO|The Vita Coco Company, Inc.
COCP|Cocrystal Pharma, Inc.
CODA|Coda Octopus Group, Inc.
CODX|Co
COEP|Coeptis Therapeutics Holdings, Inc.
COEPW|Coeptis Therapeutics Holdings, Inc.
COFS|ChoiceOne Financial Services, Inc.
COGT|Cogent Biosciences, Inc.
COHU|Cohu, Inc.
COIN|Coinbase Global, Inc.
COKE|Coca
COLB|Columbia Banking System, Inc.
COLL|Collegium Pharmaceutical, Inc.
COLM|Columbia Sportswear Company
COMM|CommScope Holding Company, Inc.
COMT|iShares GSCI Commodity Dynamic Roll Strategy 
CONI|GraniteShares  Short COIN Daily 
CONL|GraniteShares  Long COIN Daily 
COO|The Cooper Companies, Inc.
COOP|Mr. Cooper Group Inc.
COOT|Australian Oilseeds Holdings Limited
COOTW|Australian Oilseeds Holdings Limited
COPJ|Sprott Junior Copper Miners 
COPP|Sprott Copper Miners 
CORT|Corcept Therapeutics Incorporated
CORZ|Core Scientific, Inc.
CORZW|Core Scientific, Inc.
CORZZ|Core Scientific, Inc.
COSM|Cosmos Health Inc.
COST|Costco Wholesale Corporation
COWG|Pacer US Large Cap Cash Cows Growth Leaders 
COWS|Amplify Cash Flow Dividend Leaders 
COYA|Coya Therapeutics, Inc.
CPB|The Campbell's Company
CPBI|Central Plains Bancshares, Inc.
CPHC|Canterbury Park Holding Corporation
CPIX|Cumberland Pharmaceuticals Inc.
CPLS|AB Core Plus Bond 
CPOP|Pop Culture Group Co., Ltd
CPRT|Copart, Inc.
CPRX|Catalyst Pharmaceuticals, Inc.
CPSH|CPS Technologies Corp.
CPSS|Consumer Portfolio Services, Inc.
CPTN|Cepton, Inc.
CPTNW|Cepton, Inc.
CPZ|Calamos Long/Short Equity & Dynamic Income Trust
CRAI|CRA International,Inc.
CRBP|Corbus Pharmaceuticals Holdings, Inc.
CRBU|Caribou Biosciences, Inc.
CRCT|Cricut, Inc.
CRDF|Cardiff Oncology, Inc.
CRDL|Cardiol Therapeutics Inc.
CRDO|Credo Technology Group Holding Ltd
CREG|Smart Powerr Corp.
CRESW|Cresud S.A.C.I.F. y A.
CRESY|Cresud S.A.C.I.F. y A.
CREV|Carbon Revolution Public Limited Company
CREVW|Carbon Revolution Public Limited Company
CREX|Creative Realities, Inc.
CRGO|Freightos Limited
CRGOW|Freightos Limited
CRGX|CARGO Therapeutics, Inc.
CRIS|Curis, Inc.
CRKN|Crown Electrokinetics Corp.
CRMD|CorMedix Inc.
CRML|Critical Metals Corp.
CRMLW|Critical Metals Corp.
CRMT|America's Car
CRNC|Cerence Inc.
CRNT|Ceragon Networks Ltd.
CRNX|Crinetics Pharmaceuticals, Inc.
CRON|Cronos Group Inc.
CROX|Crocs, Inc.
CRSP|CRISPR Therapeutics AG
CRSR|Corsair Gaming, Inc.
CRTO|Criteo S.A.
CRUS|Cirrus Logic, Inc.
CRVL|CorVel Corp.
CRVO|CervoMed Inc.
CRVS|Corvus Pharmaceuticals, Inc.
CRWD|CrowdStrike Holdings, Inc.
CRWL|GraniteShares  Long CRWD Daily 
CRWS|Crown Crafts, Inc.
CSA|VictoryShares US Small Cap Volatility Wtd 
CSB|VictoryShares US Small Cap High Div Volatility Wtd 
CSBR|Champions Oncology, Inc.
CSCI|COSCIENS Biopharma Inc.
CSCO|Cisco Systems, Inc.
CSF|VictoryShares US Discovery Enhanced Volatility Wtd 
CSGP|CoStar Group, Inc.
CSGS|CSG Systems International, Inc.
CSIQ|Canadian Solar Inc.
CSLM|CSLM Acquisition Corp.
CSLMR|CSLM Acquisition Corp.
CSLMU|CSLM Acquisition Corp.
CSLMW|CSLM Acquisition Corp.
CSLR|Complete Solaria, Inc.
CSLRW|Complete Solaria, Inc.
CSPI|CSP Inc.
CSQ|Calamos Strategic Total Return Fund
CSTE|Caesarstone Ltd.
CSTL|Castle Biosciences, Inc.
CSWC|Capital Southwest Corporation
CSWCZ|Capital Southwest Corporation
CSWI|CSW Industrials, Inc.
CSX|CSX Corporation
CTAS|Cintas Corporation
CTBI|Community Trust Bancorp, Inc.
CTCX|Carmell Corporation
CTCXW|Carmell Corporation
CTEC|Global X CleanTech 
CTHR|Charles & Colvard Ltd.
CTKB|Cytek Biosciences, Inc.
CTLP|Cantaloupe, Inc.
CTMX|CytomX Therapeutics, Inc.
CTNM|Contineum Therapeutics, Inc.
CTNT|Cheetah Net Supply Chain Service Inc.
CTOR|Citius Oncology, Inc.
CTRM|Castor Maritime Inc.
CTRN|Citi Trends, Inc.
CTSH|Cognizant Technology Solutions Corporation
CTSO|Cytosorbents Corporation
CTXR|Citius Pharmaceuticals, Inc.
CUB|Lionheart Holdings
CUBA|The Herzfeld Caribbean Basin Fund, Inc.
CUBWU|Lionheart Holdings
CUBWW|Lionheart Holdings
CUE|Cue Biopharma, Inc.
CURI|CuriosityStream Inc.
CURIW|CuriosityStream Inc.
CURR|Currenc Group Inc.
CUTR|Cutera, Inc.
CVAC|CureVac N.V.
CVBF|CVB Financial Corporation
CVCO|Cavco Industries, Inc.
CVGI|Commercial Vehicle Group, Inc.
CVGW|Calavo Growers, Inc.
CVKD|Cadrenal Therapeutics, Inc.
CVLT|Commvault Systems, Inc.
CVRX|CVRx, Inc.
CVV|CVD Equipment Corporation
CWBC|Community West Bancshares
CWCO|Consolidated Water Co. Ltd.
CWD|CaliberCos Inc.
CWST|Casella Waste Systems, Inc.
CXAI|CXApp Inc.
CXAIW|CXApp Inc.
CXDO|Crexendo, Inc.
CXSE|WisdomTree China ex
CYBR|CyberArk Software Ltd.
CYCC|Cyclacel Pharmaceuticals, Inc.
CYCCP|Cyclacel Pharmaceuticals, Inc.
CYCN|Cyclerion Therapeutics, Inc.
CYN|Cyngn Inc.
CYRX|CryoPort, Inc.
CYTH|Cyclo Therapeutics, Inc.
CYTHW|Cyclo Therapeutics, Inc.
CYTK|Cytokinetics, Incorporated
CYTO|Altamira Therapeutics Ltd.
CZAR|Themes Natural Monopoly 
CZFS|Citizens Financial Services, Inc.
CZNC|Citizens & Northern Corp
CZR|Caesars Entertainment, Inc.
CZWI|Citizens Community Bancorp, Inc.
DADA|Dada Nexus Limited
DAIO|Data I/O Corporation
DAKT|Daktronics, Inc.
DALI|First Trust Dorsey Wright DALI 1 
DALN|DallasNews Corporation
DAPP|VanEck Digital Transformation 
DARE|Dare Bioscience, Inc.
DASH|DoorDash, Inc.
DATS|DatChat, Inc.
DATSW|DatChat, Inc.
DAVE|Dave Inc.
DAVEW|Dave Inc.
DAWN|Day One Biopharmaceuticals, Inc.
DAX|Global X DAX Germany 
DBGI|Digital Brands Group, Inc.
DBGIW|Digital Brands Group, Inc.
DBVT|DBV Technologies S.A.
DBX|Dropbox, Inc.
DCAP|Unity Wealth Partners Dynamic Capital Appreciation & Options 
DCBO|Docebo Inc.
DCGO|DocGo Inc.
DCOM|Dime Community Bancshares, Inc.
DCOMG|Dime Community Bancshares, Inc.
DCOMP|Dime Community Bancshares, Inc.
DCTH|Delcath Systems, Inc.
DDI|DoubleDown Interactive Co., Ltd.
DDIV|First Trust Dorsey Wright Momentum & Dividend 
DDOG|Datadog, Inc.
DECA|Denali Capital Acquisition Corp.
DECAU|Denali Capital Acquisition Corp.
DECAW|Denali Capital Acquisition Corp.
DECO|SPDR Galaxy Digital Asset Ecosystem 
DEMZ|Democratic Large Cap Core 
DENN|Denny's Corporation
DERM|Journey Medical Corporation
DEVS|DevvStream Corp.
DFGP|Dimensional Global Core Plus Fixed Income 
DFGX|Dimensional Global ex US Core Fixed Income 
DFLI|Dragonfly Energy Holdings Corp
DFLIW|Dragonfly Energy Holdings Corp
DGCB|Dimensional Global Credit 
DGHI|Digihost Technology Inc.
DGICA|Donegal Group, Inc.
DGICB|Donegal Group, Inc.
DGII|Digi International Inc.
DGLY|Digital Ally, Inc.
DGRE|WisdomTree Emerging Markets Quality Dividend Growth Fund
DGRS|WisdomTree U.S. SmallCap Quality Dividend Growth Fund
DGRW|WisdomTree U.S. Quality Dividend Growth Fund
DH|Definitive Healthcare Corp.
DHAI|DIH Holding US, Inc.
DHAIW|DIH Holding US, Inc.
DHC|Diversified Healthcare Trust
DHCNI|Diversified Healthcare Trust
DHCNL|Diversified Healthcare Trust
DHIL|Diamond Hill Investment Group, Inc.
DIBS|1stdibs.com, Inc.
DIOD|Diodes Incorporated
DIST|Distoken Acquisition Corporation
DISTR|Distoken Acquisition Corporation
DISTW|Distoken Acquisition Corporation
DIVD|Altrius Global Dividend 
DJCO|Daily Journal Corp. (S.C.)
DJT|Trump Media & Technology Group Corp.
DJTWW|Trump Media & Technology Group Corp.
DKNG|DraftKings Inc.
DLHC|DLH Holdings Corp.
DLO|DLocal Limited
DLPN|Dolphin Entertainment, Inc.
DLTH|Duluth Holdings Inc.
DLTR|Dollar Tree, Inc.
DMAC|DiaMedica Therapeutics Inc.
DMAT|Global X Disruptive Materials 
DMLP|Dorchester Minerals, L.P.
DMN|Damon Inc.
DMRC|Digimarc Corporation
DMXF|iShares ESG Advanced MSCI EAFE 
DNLI|Denali Therapeutics Inc.
DNTH|Dianthus Therapeutics, Inc.
DNUT|Krispy Kreme, Inc.
DOCU|DocuSign, Inc.
DOGZ|Dogness (International) Corporation
DOMH|Dominari Holdings Inc.
DOMO|Domo, Inc.
DOOO|BRP Inc.
DORM|Dorman Products, Inc.
DOX|Amdocs Limited
DOYU|DouYu International Holdings Limited
DPRO|Draganfly Inc.
DRCT|Direct Digital Holdings, Inc.
DRIO|DarioHealth Corp.
DRIV|Global X Autonomous & Electric Vehicles 
DRMA|Dermata Therapeutics, Inc.
DRMAW|Dermata Therapeutics, Inc.
DRRX|DURECT Corporation
DRS|Leonardo DRS, Inc.
DRTS|Alpha Tau Medical Ltd.
DRTSW|Alpha Tau Medical Ltd.
DRUG|Bright Minds Biosciences Inc.
DRVN|Driven Brands Holdings Inc.
DSGN|Design Therapeutics, Inc.
DSGR|Distribution Solutions Group, Inc.
DSGX|The Descartes Systems Group Inc.
DSP|Viant Technology Inc.
DSWL|Deswell Industries, Inc.
DSY|Big Tree Cloud Holdings Limited
DSYWW|Big Tree Cloud Holdings Limited
DTCK|Davis Commodities Limited
DTCR|Global X Data Center & Digital Infrastructure 
DTI|Drilling Tools International Corporation
DTIL|Precision BioSciences, Inc.
DTSQ|DT Cloud Star Acquisition Corporation
DTSQR|DT Cloud Star Acquisition Corporation
DTSQU|DT Cloud Star Acquisition Corporation
DTSS|Datasea Inc.
DTST|Data Storage Corporation
DTSTW|Data Storage Corporation
DUET|DUET Acquisition Corp.
DUETU|DUET Acquisition Corp.
DUETW|DUET Acquisition Corp.
DUKH|Ocean Park High Income 
DUKX|Ocean Park International 
DUO|Fangdd Network Group Ltd.
DUOL|Duolingo, Inc.
DUOT|Duos Technologies Group, Inc.
DVAL|BrandywineGLOBAL
DVAX|Dynavax Technologies Corporation
DVLU|First Trust Dorsey Wright Momentum & Value 
DVOL|First Trust Dorsey Wright Momentum & Low Volatility 
DVY|iShares Select Dividend 
DWAS|Invesco Dorsey Wright SmallCap Momentum 
DWAW|AdvisorShares Dorsey Wright FSM All Cap World 
DWSH|AdvisorShares Dorsey Wright Short 
DWSN|Dawson Geophysical Company
DWTX|Dogwood Therapeutics, Inc.
DWUS|AdvisorShares Dorsey Wright FSM US Core 
DXCM|DexCom, Inc.
DXJS|WisdomTree Japan Hedged SmallCap Equity Fund
DXLG|Destination XL Group, Inc.
DXPE|DXP Enterprises, Inc.
DXR|Daxor Corporation
DYAI|Dyadic International, Inc.
DYCQ|DT Cloud Acquisition Corporation
DYCQR|DT Cloud Acquisition Corporation
DYCQU|DT Cloud Acquisition Corporation
DYFI|IDX Dynamic Fixed Income 
DYN|Dyne Therapeutics, Inc.
DYNI|IDX Dynamic Innovation 
DYNXU|Dynamix Corporation
DYTA|SGI Dynamic Tactical 
EA|Electronic Arts Inc.
EAST|Eastside Distilling, Inc.
EBAY|eBay Inc.
EBC|Eastern Bankshares, Inc.
EBIZ|Global X E
EBMT|Eagle Bancorp Montana, Inc.
EBON|Ebang International Holdings Inc.
EBTC|Enterprise Bancorp Inc
ECBK|ECB Bancorp, Inc.
ECDA|ECD Automotive Design, Inc.
ECDAW|ECD Automotive Design, Inc.
ECOR|electroCore, Inc.
ECOW|Pacer Emerging Markets Cash Cows 100 
ECPG|Encore Capital Group Inc
ECX|ECARX Holdings Inc.
ECXWW|ECARX Holdings Inc.
EDAP|EDAP TMS S.A.
EDBL|Edible Garden AG Incorporated
EDBLW|Edible Garden AG Incorporated
EDIT|Editas Medicine, Inc.
EDOC|Global X Telemedicine & Digital Health 
EDRY|EuroDry Ltd.
EDSA|Edesa Biotech, Inc.
EDTK|Skillful Craftsman Education Technology Limited
EDUC|Educational Development Corporation
EEFT|Euronet Worldwide, Inc.
EEIQ|EpicQuest Education Group International Limited
EEMA|iShares MSCI Emerging Markets Asia 
EFAS|Global X MSCI SuperDividend EAFE 
EFOI|Energy Focus, Inc.
EFRA|iShares Environmental Infrastructure and Industrials 
EFSC|Enterprise Financial Services Corporation
EFSCP|Enterprise Financial Services Corporation
EGAN|eGain Corporation
EGBN|Eagle Bancorp, Inc.
EGHT|8x8 Inc
EH|EHang Holdings Limited
EHGO|Eshallgo Inc.
EHLS|Even Herd Long Short 
EHTH|eHealth, Inc.
EJH|E
EKG|First Trust Nasdaq Lux Digital Health Solutions 
EKSO|Ekso Bionics Holdings, Inc.
ELAB|Elevai Labs, Inc.
ELBM|Electra Battery Materials Corporation
ELDN|Eledon Pharmaceuticals, Inc.
ELEV|Elevation Oncology, Inc.
ELPW|Elong Power Holding Limited
ELSE|Electro
ELTK|Eltek Ltd.
ELTX|Elicio Therapeutics, Inc.
ELUT|Elutia, Inc.
ELVA|Electrovaya Inc.
ELVN|Enliven Therapeutics, Inc.
ELWS|Earlyworks Co., Ltd.
EM|Smart Share Global Limited
EMBC|Embecta Corp.
EMCB|WisdomTree Emerging Markets Corporate Bond Fund
EMCG|Embrace Change Acquisition Corp
EMCGR|Embrace Change Acquisition Corp
EMCGU|Embrace Change Acquisition Corp
EMCGW|Embrace Change Acquisition Corp
EMEQ|Macquarie Focused Emerging Markets Equity 
EMIF|iShares Emerging Markets Infrastructure 
EMKR|EMCORE Corporation
EML|Eastern Company (The)
EMXC|iShares MSCI Emerging Markets ex China 
EMXF|iShares ESG Advanced MSCI EM 
ENG|ENGlobal Corporation
ENGN|enGene Holdings Inc.
ENGNW|enGene Holdings Inc.
ENLT|Enlight Renewable Energy Ltd.
ENLV|Enlivex Therapeutics Ltd.
ENPH|Enphase Energy, Inc.
ENSC|Ensysce Biosciences, Inc.
ENSG|The Ensign Group, Inc.
ENTA|Enanta Pharmaceuticals, Inc.
ENTG|Entegris, Inc.
ENTO|Entero Therapeutics Inc.
ENTX|Entera Bio Ltd.
ENVB|Enveric Biosciences, Inc.
ENVX|Enovix Corporation
ENZL|iShares MSCI New Zealand 
EOLS|Evolus, Inc.
EOSE|Eos Energy Enterprises, Inc.
EOSEW|Eos Energy Enterprises, Inc.
EPIX|ESSA Pharma Inc.
EPOW|Sunrise New Energy Co., Ltd
EPRX|Eupraxia Pharmaceuticals Inc.
EPSN|Epsilon Energy Ltd.
EQ|Equillium, Inc.
EQIX|Equinix, Inc.
EQRR|ProShares Equities for Rising Rates 
ERAS|Erasca, Inc.
ERET|iShares Environmentally Aware Real Estate 
ERIC|Ericsson
ERIE|Erie Indemnity Company
ERII|Energy Recovery, Inc.
ERNA|Eterna Therapeutics Inc.
ERNZ|TrueShares Active Yield 
ESCA|Escalade, Incorporated
ESEA|Euroseas Ltd.
ESGD|iShares ESG Aware MSCI EAFE 
ESGE|iShares ESG Aware MSCI EM 
ESGL|ESGL Holdings Limited
ESGLW|ESGL Holdings Limited
ESGR|Enstar Group Limited
ESGRO|Enstar Group Limited
ESGRP|Enstar Group Limited
ESGU|iShares ESG Aware MSCI USA 
ESHA|ESH Acquisition Corp.
ESHAR|ESH Acquisition Corp.
ESLA|Estrella Immunopharma, Inc.
ESLAW|Estrella Immunopharma, Inc.
ESLT|Elbit Systems Ltd.
ESMV|iShares ESG MSCI USA Min Vol Factor 
ESN|Essential 40 Stock 
ESOA|Energy Services of America Corporation
ESPO|VanEck Video Gaming and eSports 
ESPR|Esperion Therapeutics, Inc.
ESQ|Esquire Financial Holdings, Inc.
ESSA|ESSA Bancorp, Inc.
ESTA|Establishment Labs Holdings Inc.
ETEC|iShares Breakthrough Environmental Solutions 
ETHA|iShares Ethereum Trust
ETNB|89bio, Inc.
ETON|Eton Pharmaceuticals, Inc.
ETSY|Etsy, Inc.
EU|enCore Energy Corp.
EUDA|Euda Health Holdings Limited
EUDAW|Euda Health Holdings Limited
EUFN|iShares MSCI Europe Financials 
EURK|Eureka Acquisition Corp
EURKR|Eureka Acquisition Corp
EURKU|Eureka Acquisition Corp
EVAX|Evaxion Biotech A/S
EVCM|EverCommerce Inc.
EVER|EverQuote, Inc.
EVGN|Evogene Ltd.
EVGO|EVgo Inc.
EVGOW|EVgo Inc.
EVGR|Evergreen Corporation
EVGRU|Evergreen Corporation
EVGRW|Evergreen Corporation
EVLV|Evolv Technologies Holdings, Inc.
EVLVW|Evolv Technologies Holdings, Inc.
EVMT|Invesco Electric Vehicle Metals Commodity Strategy No K
EVO|Evotec SE
EVOK|Evoke Pharma, Inc.
EVRG|Evergy, Inc.
EVSD|Eaton Vance Short Duration Income 
EVTV|Envirotech Vehicles, Inc.
EWBC|East West Bancorp, Inc.
EWCZ|European Wax Center, Inc.
EWJV|iShares MSCI Japan Value 
EWTX|Edgewise Therapeutics, Inc.
EWZS|iShares MSCI Brazil Small
EXAS|Exact Sciences Corporation
EXC|Exelon Corporation
EXE|Expand Energy Corporation
EXEEL|Expand Energy Corporation
EXEEW|Expand Energy Corporation
EXEEZ|Expand Energy Corporation
EXEL|Exelixis, Inc.
EXFY|Expensify, Inc.
EXLS|ExlService Holdings, Inc.
EXPE|Expedia Group, Inc.
EXPI|eXp World Holdings, Inc.
EXPO|Exponent, Inc.
EXTR|Extreme Networks, Inc.
EYE|National Vision Holdings, Inc.
EYEG|AB Corporate Bond 
EYEN|Eyenovia, Inc.
EYPT|EyePoint Pharmaceuticals, Inc.
EZFL|EzFill Holdings, Inc.
EZGO|EZGO Technologies Ltd.
EZPW|EZCORP, Inc.
FA|First Advantage Corporation
FAAR|First Trust Alternative Absolute Return Strategy 
FAAS|DigiAsia Corp.
FAASW|DigiAsia Corp.
FAB|First Trust Multi Cap Value AlphaDEX Fund
FAD|First Trust Multi Cap Growth AlphaDEX Fund
FAMI|Farmmi, INC.
FANG|Diamondback Energy, Inc.
FARM|Farmer Brothers Company
FARO|FARO Technologies, Inc.
FAST|Fastenal Company
FAT|FAT Brands Inc.
FATBB|FAT Brands Inc.
FATBP|FAT Brands Inc.
FATBW|FAT Brands Inc.
FATE|Fate Therapeutics, Inc.
FBIO|Fortress Biotech, Inc.
FBIOP|Fortress Biotech, Inc.
FBIZ|First Business Financial Services, Inc.
FBL|GraniteShares  Long META Daily 
FBLA|FB Bancorp, Inc.
FBLG|FibroBiologics, Inc.
FBNC|First Bancorp
FBOT|Fidelity Disruptive Automation 
FBRX|Forte Biosciences, Inc.
FBYD|Falcon's Beyond Global, Inc.
FBYDW|Falcon's Beyond Global, Inc.
FBZ|First Trust Brazil AlphaDEX Fund
FCA|First Trust China AlphaDEX Fund
FCAL|First Trust California Municipal High income 
FCAP|First Capital, Inc.
FCBC|First Community Bankshares, Inc.
FCCO|First Community Corporation
FCEF|First Trust Income Opportunities 
FCEL|FuelCell Energy, Inc.
FCFS|FirstCash Holdings, Inc.
FCNCA|First Citizens BancShares, Inc.
FCNCO|First Citizens BancShares, Inc.
FCNCP|First Citizens BancShares, Inc.
FCTE|SMI 3Fourteen Full
FCUV|Focus Universal Inc.
FCVT|First Trust SSI Strategic Convertible Securities 
FDBC|Fidelity D & D Bancorp, Inc.
FDCF|Fidelity Disruptive Communications 
FDFF|Fidelity Disruptive Finance 
FDIF|Fidelity Disruptors 
FDIG|Fidelity Crypto Industry and Digital Payments 
FDIV|MarketDesk Focused U.S. Dividend 
FDMT|4D Molecular Therapeutics, Inc.
FDNI|First Trust Dow Jones International Internet 
FDSB|Fifth District Bancorp, Inc.
FDT|First Trust Developed Markets Ex
FDTS|First Trust Developed Markets ex
FDTX|Fidelity Disruptive Technology 
FDUS|Fidus Investment Corporation
FEAM|5E Advanced Materials, Inc.
FEBO|Fenbo Holdings Limited
FEIM|Frequency Electronics, Inc.
FELE|Franklin Electric Co., Inc.
FEMY|Femasys Inc.
FENC|Fennec Pharmaceuticals Inc.
FEP|First Trust Europe AlphaDEX Fund
FEPI|REX FANG & Innovation Equity Premium Income 
FER|Ferrovial SE
FEUZ|First Trust Eurozone AlphaDEX 
FEX|First Trust Large Cap Core AlphaDEX Fund
FFBC|First Financial Bancorp.
FFIC|Flushing Financial Corporation
FFIE|Faraday Future Intelligent Electric Inc.
FFIEW|Faraday Future Intelligent Electric Inc.
FFIN|First Financial Bankshares, Inc.
FFIV|F5, Inc.
FFNW|First Financial Northwest, Inc.
FGBI|First Guaranty Bancshares, Inc.
FGBIP|First Guaranty Bancshares, Inc.
FGEN|FibroGen, Inc
FGF|Fundamental Global Inc.
FGFPP|Fundamental Global Inc.
FGI|FGI Industries Ltd.
FGIWW|FGI Industries Ltd.
FGL|Founder Group Limited
FGM|First Trust Germany AlphaDEX Fund
FHB|First Hawaiian, Inc.
FHTX|Foghorn Therapeutics Inc.
FIBK|First Interstate BancSystem, Inc.
FICS|First Trust International Developed Capital Strength 
FID|First Trust S&P International Dividend Aristocrats 
FINE|Themes European Luxury 
FINW|FinWise Bancorp
FINX|Global X FinTech 
FIP|FTAI Infrastructure Inc.
FISI|Financial Institutions, Inc.
FITB|Fifth Third Bancorp
FITBI|Fifth Third Bancorp
FITBO|Fifth Third Bancorp
FITBP|Fifth Third Bancorp
FIVE|Five Below, Inc.
FIVN|Five9, Inc.
FIXD|First Trust TCW Opportunistic Fixed Income 
FIZZ|National Beverage Corp.
FJP|First Trust Japan AlphaDEX Fund
FKU|First Trust United Kingdom AlphaDEX Fund
FKWL|Franklin Wireless Corp.
FLD|FTAC Emerald Acquisition Corp.
FLDDU|FTAC Emerald Acquisition Corp.
FLDDW|FTAC Emerald Acquisition Corp.
FLEX|Flex Ltd.
FLGC|Flora Growth Corp.
FLGT|Fulgent Genetics, Inc.
FLIC|The First of Long Island Corporation
FLL|Full House Resorts, Inc.
FLN|First Trust Latin America AlphaDEX Fund
FLNC|Fluence Energy, Inc.
FLNT|Fluent, Inc.
FLUX|Flux Power Holdings, Inc.
FLWS|1-800-FLOWERS.COM, Inc.
FLX|BingEx Limited
FLXS|Flexsteel Industries, Inc.
FLYE|Fly
FLYW|Flywire Corporation
FMAO|Farmers & Merchants Bancorp, Inc.
FMB|First Trust Managed Municipal 
FMBH|First Mid Bancshares, Inc.
FMED|Fidelity Disruptive Medicine 
FMET|Fidelity Metaverse 
FMHI|First Trust Municipal High Income 
FMNB|Farmers National Banc Corp.
FMST|Foremost Clean Energy Ltd.
FMSTW|Foremost Clean Energy Ltd.
FNGR|FingerMotion, Inc.
FNK|First Trust Mid Cap Value AlphaDEX Fund
FNKO|Funko, Inc.
FNLC|First Bancorp, Inc (ME)
FNWB|First Northwest Bancorp
FNWD|Finward Bancorp
FNX|First Trust Mid Cap Core AlphaDEX Fund
FNY|First Trust Mid Cap Growth AlphaDEX Fund
FOLD|Amicus Therapeutics, Inc.
FONR|Fonar Corporation
FORA|Forian Inc.
FORD|Forward Industries, Inc.
FORL|Four Leaf Acquisition Corporation
FORLU|Four Leaf Acquisition Corporation
FORLW|Four Leaf Acquisition Corporation
FORM|FormFactor, Inc.
FORR|Forrester Research, Inc.
FORTY|Formula Systems (1985) Ltd.
FOSL|Fossil Group, Inc.
FOSLL|Fossil Group, Inc.
FOX|Fox Corporation
FOXA|Fox Corporation
FOXF|Fox Factory Holding Corp.
FOXX|Foxx Development Holdings Inc.
FOXXW|Foxx Development Holdings Inc.
FPA|First Trust Asia Pacific Ex
FPAY|FlexShopper, Inc.
FPXE|First Trust IPOX Europe Equity Opportunities 
FPXI|First Trust International Equity Opportunities 
FRAF|Franklin Financial Services Corporation
FRBA|First Bank
FRES|Fresh2 Group Limited
FRGT|Freight Technologies, Inc.
FRHC|Freedom Holding Corp.
FRME|First Merchants Corporation
FRMEP|First Merchants Corporation
FROG|JFrog Ltd.
FRPH|FRP Holdings, Inc.
FRPT|Freshpet, Inc.
FRSH|Freshworks Inc.
FRST|Primis Financial Corp.
FRSX|Foresight Autonomous Holdings Ltd.
FSBC|Five Star Bancorp
FSBW|FS Bancorp, Inc.
FSCS|First Trust SMID Capital Strength 
FSEA|First Seacoast Bancorp, Inc.
FSFG|First Savings Financial Group, Inc.
FSHP|Flag Ship Acquisition Corp.
FSHPR|Flag Ship Acquisition Corp.
FSHPU|Flag Ship Acquisition Corp.
FSLR|First Solar, Inc.
FSTR|L.B. Foster Company
FSUN|FirstSun Capital Bancorp
FSV|FirstService Corporation
FSZ|First Trust Switzerland AlphaDEX Fund
FTA|First Trust Large Cap Value AlphaDEX Fund
FTAG|First Trust Indxx Global Agriculture 
FTAI|FTAI Aviation Ltd.
FTAIM|FTAI Aviation Ltd.
FTAIN|FTAI Aviation Ltd.
FTAIO|FTAI Aviation Ltd.
FTC|First Trust Large Cap Growth AlphaDEX Fund
FTCI|FTC Solar, Inc.
FTCS|First Trust Capital Strength 
FTDR|Frontdoor, Inc.
FTDS|First Trust Dividend Strength 
FTEK|Fuel Tech, Inc.
FTEL|Fitell Corporation
FTFT|Future FinTech Group Inc.
FTGC|First Trust Global Tactical Commodity Strategy Fund
FTGS|First Trust Growth Strength 
FTHI|First Trust BuyWrite Income 
FTHM|Fathom Holdings Inc.
FTII|FutureTech II Acquisition Corp.
FTIIU|FutureTech II Acquisition Corp.
FTIIW|FutureTech II Acquisition Corp.
FTLF|FitLife Brands, Inc.
FTNT|Fortinet, Inc.
FTQI|First Trust Nasdaq BuyWrite Income 
FTRE|Fortrea Holdings Inc.
FTRI|First Trust Indxx Global Natural Resources Income 
FTSL|First Trust Senior Loan Fund
FTSM|First Trust Enhanced Short Maturity 
FTXG|First Trust Nasdaq Food & Beverage 
FTXH|First Trust Nasdaq Pharmaceuticals 
FTXL|First Trust Nasdaq Semiconductor 
FTXN|First Trust Nasdaq Oil & Gas 
FTXO|First Trust Nasdaq Bank 
FTXR|First Trust Nasdaq Transportation 
FUFU|BitFuFu Inc.
FUFUW|BitFuFu Inc.
FULC|Fulcrum Therapeutics, Inc.
FULT|Fulton Financial Corporation
FULTP|Fulton Financial Corporation
FUNC|First United Corporation
FUND|Sprott Focus Trust, Inc.
FUSB|First US Bancshares, Inc.
FUTU|Futu Holdings Limited
FV|First Trust Dorsey Wright Focus 5 
FVC|First Trust Dorsey Wright Dynamic Focus 5 
FVCB|FVCBankcorp, Inc.
FVN|Future Vision II Acquisition Corporation
FVNNR|Future Vision II Acquisition Corporation
FVNNU|Future Vision II Acquisition Corporation
FWONA|Liberty Media Corporation
FWONK|Liberty Media Corporation
FWRD|Forward Air Corporation
FWRG|First Watch Restaurant Group, Inc.
FXNC|First National Corporation
FYBR|Frontier Communications Parent, Inc.
FYC|First Trust Small Cap Growth AlphaDEX Fund
FYT|First Trust Small Cap Value AlphaDEX Fund
FYX|First Trust Small Cap Core AlphaDEX Fund
GABC|German American Bancorp, Inc.
GAIA|Gaia, Inc.
GAIN|Gladstone Investment Corporation
GAINL|Gladstone Investment Corporation
GAINN|Gladstone Investment Corporation
GAINZ|Gladstone Investment Corporation
GALT|Galectin Therapeutics Inc.
GAMB|Gambling.com Group Limited
GAME|GameSquare Holdings, Inc.
GAN|GAN Limited
GANX|Gain Therapeutics, Inc.
GASS|StealthGas, Inc.
GATE|Marblegate Acquisition Corp.
GATEU|Marblegate Acquisition Corp.
GATEW|Marblegate Acquisition Corp.
GAUZ|Gauzy Ltd.
GBBK|Global Blockchain Acquisition Corp.
GBBKR|Global Blockchain Acquisition Corp.
GBBKW|Global Blockchain Acquisition Corp.
GBDC|Golub Capital BDC, Inc.
GBIO|Generation Bio Co.
GCBC|Greene County Bancorp, Inc.
GCMG|GCM Grosvenor Inc.
GCMGW|GCM Grosvenor Inc.
GCT|GigaCloud Technology Inc
GCTK|GlucoTrack, Inc.
GDC|GD Culture Group Limited
GDEN|Golden Entertainment, Inc.
GDEV|GDEV Inc.
GDEVW|GDEV Inc.
GDHG|Golden Heaven Group Holdings Ltd.
GDRX|GoodRx Holdings, Inc.
GDS|GDS Holdings Limited
GDST|Goldenstone Acquisition Limited
GDSTR|Goldenstone Acquisition Limited
GDSTU|Goldenstone Acquisition Limited
GDSTW|Goldenstone Acquisition Limited
GDTC|CytoMed Therapeutics Limited
GDYN|Grid Dynamics Holdings, Inc.
GECC|Great Elm Capital Corp.
GECCH|Great Elm Capital Corp.
GECCI|Great Elm Capital Corp.
GECCO|Great Elm Capital Corp.
GECCZ|Great Elm Capital Corp.
GEG|Great Elm Group, Inc.
GEGGL|Great Elm Group, Inc.
GEHC|GE HealthCare Technologies Inc.
GELS|Gelteq Limited
GEN|Gen Digital Inc.
GENE|Genetic Technologies Ltd
GENK|GEN Restaurant Group, Inc.
GEOS|Geospace Technologies Corporation
GERN|Geron Corporation
GEVO|Gevo, Inc.
GFAI|Guardforce AI Co., Limited
GFAIW|Guardforce AI Co., Limited
GFGF|Guru Favorite Stocks 
GFS|GlobalFoundries Inc.
GGAL|Grupo Financiero Galicia S.A.
GGR|Gogoro Inc.
GGROW|Gogoro Inc.
GH|Guardant Health, Inc.
GHIX|Gores Holdings IX, Inc.
GHIXU|Gores Holdings IX, Inc.
GHIXW|Gores Holdings IX, Inc.
GHRS|GH Research PLC
GIFI|Gulf Island Fabrication, Inc.
GIFT|Giftify, Inc.
GIG|GigCapital7 Corp.
GIGGU|GigCapital7 Corp.
GIGGW|GigCapital7 Corp.
GIGM|GigaMedia Limited
GIII|G
GILD|Gilead Sciences, Inc.
GILT|Gilat Satellite Networks Ltd.
GINX|SGI Enhanced Global Income 
GIPR|Generation Income Properties Inc.
GIPRW|Generation Income Properties Inc.
GLAC|Global Lights Acquisition Corp
GLACR|Global Lights Acquisition Corp
GLACU|Global Lights Acquisition Corp
GLAD|Gladstone Capital Corporation
GLADZ|Gladstone Capital Corporation
GLBE|Global
GLBS|Globus Maritime Limited
GLBZ|Glen Burnie Bancorp
GLDD|Great Lakes Dredge & Dock Corporation
GLDI|ETRACS Gold Shares Covered Call ETNs due February 2, 2033
GLE|Global Engine Group Holding Limited
GLLI|Globalink Investment Inc.
GLLIR|Globalink Investment Inc.
GLLIU|Globalink Investment Inc.
GLLIW|Globalink Investment Inc.
GLMD|Galmed Pharmaceuticals Ltd.
GLNG|Golar LNG Limited
GLOW|VictoryShares WestEnd Global Equity 
GLPG|Galapagos NV
GLPI|Gaming and Leisure Properties, Inc.
GLRE|Greenlight Reinsurance, Ltd.
GLSI|Greenwich LifeSciences, Inc.
GLST|Global Star Acquisition, Inc.
GLSTR|Global Star Acquisition, Inc.
GLSTU|Global Star Acquisition, Inc.
GLSTW|Global Star Acquisition, Inc.
GLTO|Galecto, Inc.
GLUE|Monte Rosa Therapeutics, Inc.
GLXG|Galaxy Payroll Group Limited
GLYC|GlycoMimetics, Inc.
GMAB|Genmab A/S
GMGI|Golden Matrix Group, Inc.
GMM|Global Mofy AI Limited
GNFT|GENFIT S.A.
GNLN|Greenlane Holdings, Inc.
GNLX|Genelux Corporation
GNMA|iShares GNMA Bond 
GNOM|Global X Genomics & Biotechnology 
GNPX|Genprex, Inc.
GNSS|Genasys Inc.
GNTA|Genenta Science S.p.A.
GNTX|Gentex Corporation
GO|Grocery Outlet Holding Corp.
GOCO|GoHealth, Inc.
GODN|Golden Star Acquisition Corporation
GODNR|Golden Star Acquisition Corporation
GODNU|Golden Star Acquisition Corporation
GOEV|Canoo Inc.
GOEVW|Canoo Inc.
GOGL|Golden Ocean Group Limited
GOGO|Gogo Inc.
GOOD|Gladstone Commercial Corporation
GOODN|Gladstone Commercial Corporation
GOODO|Gladstone Commercial Corporation
GOOG|Alphabet Inc.
GOOGL|Alphabet Inc.
GORV|Lazydays Holdings, Inc.
GOSS|Gossamer Bio, Inc.
GOVI|Invesco Equal Weight 0
GOVX|GeoVax Labs, Inc.
GOVXW|GeoVax Labs, Inc.
GP|GreenPower Motor Company Inc.
GPAT|GP
GPATU|GP
GPATW|GP
GPCR|Structure Therapeutics Inc.
GPIQ|Goldman Sachs Nasdaq
GPIX|Goldman Sachs S&P 500 Core Premium Income 
GPRE|Green Plains, Inc.
GPRF|Goldman Sachs Access U.S. Preferred Stock and Hybrid Securities 
GPRO|GoPro, Inc.
GQQQ|Astoria US Quality Growth Kings 
GRAB|Grab Holdings Limited
GRABW|Grab Holdings Limited
GRAL|GRAIL, Inc.
GRCE|Grace Therapeutics, Inc.
GREE|Greenidge Generation Holdings Inc.
GREEL|Greenidge Generation Holdings Inc.
GRFS|Grifols, S.A.
GRI|GRI Bio, Inc.
GRID|First Trust NASDAQ Clean Edge Smart Grid Infrastructure Index Fund
GRNQ|Greenpro Capital Corp.
GROW|U.S. Global Investors, Inc.
GRPN|Groupon, Inc.
GRRR|Gorilla Technology Group Inc.
GRRRW|Gorilla Technology Group Inc.
GRVY|GRAVITY Co., Ltd.
GRWG|GrowGeneration Corp.
GRYP|Gryphon Digital Mining, Inc
GSBC|Great Southern Bancorp, Inc.
GSHD|Goosehead Insurance, Inc.
GSIB|Themes Global Systemically Important Banks 
GSIT|GSI Technology, Inc.
GSIW|Garden Stage Limited
GSM|Ferroglobe PLC
GSMGW|Cheer Holding, Inc.
GSRTU|GSR III Acquisition Corp.
GSUN|Golden Sun Health Technology Group Limited
GT|The Goodyear Tire & Rubber Company
GTBP|GT Biopharma, Inc.
GTEC|Greenland Technologies Holding Corporation
GTI|Graphjet Technology
GTIM|Good Times Restaurants Inc.
GTLB|GitLab Inc.
GTR|WisdomTree Target Range Fund
GTX|Garrett Motion Inc.
GURE|Gulf Resources, Inc.
GUTS|Fractyl Health, Inc.
GV|Visionary Holdings Inc.
GVH|Globavend Holdings Limited
GWAV|Greenwave Technology Solutions, Inc.
GWRS|Global Water Resources, Inc.
GXAI|Gaxos.ai Inc.
GXTG|Global X Thematic Growth 
GYRE|Gyre Therapeutics, Inc.
GYRO|Gyrodyne , LLC
HAFC|Hanmi Financial Corporation
HAIA|Healthcare AI Acquisition Corp.
HAIAU|Healthcare AI Acquisition Corp.
HAIAW|Healthcare AI Acquisition Corp.
HAIN|The Hain Celestial Group, Inc.
HALO|Halozyme Therapeutics, Inc.
HAO|Haoxi Health Technology Limited
HAS|Hasbro, Inc.
HBAN|Huntington Bancshares Incorporated
HBANL|Huntington Bancshares Incorporated
HBANM|Huntington Bancshares Incorporated
HBANP|Huntington Bancshares Incorporated
HBCP|Home Bancorp, Inc.
HBIO|Harvard Bioscience, Inc.
HBNC|Horizon Bancorp, Inc.
HBT|HBT Financial, Inc.
HCAT|Health Catalyst, Inc
HCKT|The Hackett Group, Inc.
HCM|HUTCHMED (China) Limited
HCOW|Amplify Cash Flow High Income 
HCP|HashiCorp, Inc.
HCSG|Healthcare Services Group, Inc.
HCTI|Healthcare Triangle, Inc.
HCVI|Hennessy Capital Investment Corp. VI
HCVIU|Hennessy Capital Investment Corp. VI
HCVIW|Hennessy Capital Investment Corp. VI
HCWB|HCW Biologics Inc.
HDL|SUPER HI INTERNATIONAL HOLDING LTD.
HDSN|Hudson Technologies, Inc.
HEAR|Turtle Beach Corporation
HECO|SPDR Galaxy Hedged Digital Asset Ecosystem 
HEES|H&E Equipment Services, Inc.
HEJD|VictoryShares Hedged Equity Income 
HELE|Helen of Troy Limited
HEPA|Hepion Pharmaceuticals, Inc.
HEPS|D
HERD|Pacer Cash Cows Fund of Funds 
HERO|Global X Video Games & Esports 
HFBL|Home Federal Bancorp, Inc. of Louisiana
HFFG|HF Foods Group Inc.
HFSP|TradersAI Large Cap Equity & Cash 
HFWA|Heritage Financial Corporation
HGBL|Heritage Global Inc.
HHS|Harte Hanks, Inc.
HIDE|Alpha Architect High Inflation and Deflation 
HIFS|Hingham Institution for Savings
HIHO|Highway Holdings Limited
HIMX|Himax Technologies, Inc.
HISF|First Trust High Income Strategic Focus 
HITI|High Tide Inc.
HIVE|HIVE Digital Technologies Ltd
HKIT|Hitek Global Inc.
HLAL|Wahed FTSE USA Shariah 
HLIT|Harmonic Inc.
HLMN|Hillman Solutions Corp.
HLNE|Hamilton Lane Incorporated
HLP|Hongli Group Inc.
HLVX|HilleVax, Inc.
HLXB|Helix Acquisition Corp. II
HMST|HomeStreet, Inc.
HNDL|Strategy Shares Nasdaq 7HANDL Index 
HNNA|Hennessy Advisors, Inc.
HNNAZ|Hennessy Advisors, Inc.
HNRG|Hallador Energy Company
HNST|The Honest Company, Inc.
HNVR|Hanover Bancorp, Inc.
HOFT|Hooker Furnishings Corporation
HOFV|Hall of Fame Resort & Entertainment Company
HOFVW|Hall of Fame Resort & Entertainment Company
HOLO|MicroCloud Hologram Inc.
HOLOW|MicroCloud Hologram Inc.
HOLX|Hologic, Inc.
HON|Honeywell International Inc.
HOND|HCM II Acquisition Corp.
HONDU|HCM II Acquisition Corp.
HONDW|HCM II Acquisition Corp.
HONE|HarborOne Bancorp, Inc.
HOOD|Robinhood Markets, Inc.
HOOK|HOOKIPA Pharma Inc.
HOPE|Hope Bancorp, Inc.
HOTH|Hoth Therapeutics, Inc.
HOUR|Hour Loop, Inc.
HOVNP|Hovnanian Enterprises Inc
HOVR|New Horizon Aircraft Ltd.
HOVRW|New Horizon Aircraft Ltd.
HOWL|Werewolf Therapeutics, Inc.
HPAI|Helport AI Limited
HPAIW|Helport AI Limited
HPH|Highest Performances Holdings Inc.
HPK|HighPeak Energy, Inc.
HPKEW|HighPeak Energy, Inc.
HQGO|Hartford US Quality Growth 
HQI|HireQuest, Inc.
HQY|HealthEquity, Inc.
HRMY|Harmony Biosciences Holdings, Inc.
HROW|Harrow, Inc.
HROWL|Harrow, Inc.
HROWM|Harrow, Inc.
HRTS|Tema GLP
HRTX|Heron Therapeutics, Inc.
HRYU|Hanryu Holdings, Inc.
HRZN|Horizon Technology Finance Corporation
HSAI|Hesai Group
HSCS|HeartSciences Inc.
HSCSW|HeartSciences Inc.
HSDT|Helius Medical Technologies, Inc.
HSIC|Henry Schein, Inc.
HSII|Heidrick & Struggles International, Inc.
HSON|Hudson Global, Inc.
HSPO|Horizon Space Acquisition I Corp.
HSPOR|Horizon Space Acquisition I Corp.
HSPOU|Horizon Space Acquisition I Corp.
HSPOW|Horizon Space Acquisition I Corp.
HSPTU|Horizon Space Acquisition II Corp.
HST|Host Hotels & Resorts, Inc.
HSTM|HealthStream, Inc.
HTBI|HomeTrust Bancshares, Inc.
HTBK|Heritage Commerce Corp
HTCO|Caravelle International Group
HTCR|Heartcore Enterprises, Inc.
HTHT|H World Group Limited
HTIA|National Healthcare Properties, Inc.
HTIBP|National Healthcare Properties, Inc.
HTLD|Heartland Express, Inc.
HTLF|Heartland Financial USA, Inc.
HTLFP|Heartland Financial USA, Inc.
HTLM|HomesToLife Ltd
HTOO|Fusion Fuel Green PLC
HTOOW|Fusion Fuel Green PLC
HTZ|Hertz Global Holdings, Inc
HTZWW|Hertz Global Holdings, Inc
HUBC|Hub Cyber Security Ltd.
HUBCW|Hub Cyber Security Ltd.
HUBCZ|Hub Cyber Security Ltd.
HUBG|Hub Group, Inc.
HUDA|Hudson Acquisition I Corp.
HUDAR|Hudson Acquisition I Corp.
HUDAU|Hudson Acquisition I Corp.
HUDI|Huadi International Group Co., Ltd.
HUHU|HUHUTECH International Group Inc.
HUIZ|Huize Holding Limited
HUMA|Humacyte, Inc.
HUMAW|Humacyte, Inc.
HURA|TuHURA Biosciences, Inc.
HURC|Hurco Companies, Inc.
HURN|Huron Consulting Group Inc.
HUT|Hut 8 Corp.
HWAY|Themes US Infrastructure 
HWBK|Hawthorn Bancshares, Inc.
HWC|Hancock Whitney Corporation
HWCPZ|Hancock Whitney Corporation
HWH|HWH International Inc.
HWKN|Hawkins, Inc.
HYBI|NEOS Enhanced Income Credit Select 
HYDR|Global X Hydrogen 
HYFM|Hydrofarm Holdings Group, Inc.
HYLS|First Trust Tactical High Yield 
HYMC|Hycroft Mining Holding Corporation
HYMCL|Hycroft Mining Holding Corporation
HYMCW|Hycroft Mining Holding Corporation
HYPR|Hyperfine, Inc.
HYZN|Hyzon Motors Inc.
HYZNW|Hyzon Motors Inc.
IAC|IAC Inc.
IART|Integra LifeSciences Holdings Corporation
IAS|Integral Ad Science Holding Corp.
IBAC|IB Acquisition Corp.
IBACR|IB Acquisition Corp.
IBAT|iShares Energy Storage & Materials 
IBB|iShares Biotechnology 
IBBQ|Invesco Nasdaq Biotechnology 
IBCP|Independent Bank Corporation
IBEX|IBEX Limited
IBG|Innovation Beverage Group Limited
IBKR|Interactive Brokers Group, Inc.
IBOC|International Bancshares Corporation
IBOT|VanEck Robotics 
IBRX|ImmunityBio, Inc.
IBTX|Independent Bank Group, Inc
ICAD|icad inc.
ICCC|ImmuCell Corporation
ICCH|ICC Holdings, Inc.
ICCM|IceCure Medical Ltd.
ICCT|iCoreConnect Inc.
ICFI|ICF International, Inc.
ICG|Intchains Group Limited
ICHR|Ichor Holdings
ICLK|iClick Interactive Asia Group Limited
ICLN|iShares Global Clean Energy 
ICLR|ICON plc
ICMB|Investcorp Credit Management BDC, Inc.
ICON|Icon Energy Corp.
ICOP|iShares Copper and Metals Mining 
ICU|SeaStar Medical Holding Corporation
ICUCW|SeaStar Medical Holding Corporation
ICUI|ICU Medical, Inc.
IDAI|T Stamp Inc.
IDCC|InterDigital, Inc.
IDN|Intellicheck, Inc.
IDXX|IDEXX Laboratories, Inc.
IDYA|IDEAYA Biosciences, Inc.
IEF|iShares 7
IEI|iShares 3
IEP|Icahn Enterprises L.P.
IESC|IES Holdings, Inc.
IEUS|iShares MSCI Europe Small
IFBD|Infobird Co., Ltd
IFGL|iShares International Developed Real Estate 
IFRX|InflaRx N.V.
IGIC|International General Insurance Holdings Ltd.
IGMS|IGM Biosciences, Inc.
IGTA|Inception Growth Acquisition Limited
IGTAR|Inception Growth Acquisition Limited
IGTAU|Inception Growth Acquisition Limited
IGTAW|Inception Growth Acquisition Limited
IHRT|iHeartMedia, Inc.
IHYF|Invesco High Yield Bond Factor 
III|Information Services Group, Inc.
IIIV|i3 Verticals, Inc.
IINN|Inspira Technologies Oxy B.H.N. Ltd.
IINNW|Inspira Technologies Oxy B.H.N. Ltd.
IJT|iShares S&P SmallCap 600 Growth 
IKNA|Ikena Oncology, Inc.
IKT|Inhibikase Therapeutics, Inc.
ILAG|Intelligent Living Application Group Inc.
ILIT|iShares Lithium Miners and Producers 
ILLR|Triller Group Inc.
ILLRW|Triller Group Inc.
ILMN|Illumina, Inc.
ILPT|Industrial Logistics Properties Trust
IMAB|I
IMCC|IM Cannabis Corp.
IMCR|Immunocore Holdings plc
IMCV|iShares Morningstar Mid
IMG|CIMG Inc.
IMKTA|Ingles Markets, Incorporated
IMMP|Immutep Limited
IMMR|Immersion Corporation
IMMX|Immix Biopharma, Inc.
IMNM|Immunome, Inc.
IMNN|Imunon, Inc.
IMOM|Alpha Architect International Quantitative Momentum 
IMOS|ChipMOS TECHNOLOGIES INC.
IMPP|Imperial Petroleum Inc.
IMPPP|Imperial Petroleum Inc.
IMRN|Immuron Limited
IMRX|Immuneering Corporation
IMTE|Integrated Media Technology Limited
IMTX|Immatics N.V.
IMTXW|Immatics N.V.
IMUX|Immunic, Inc.
IMVT|Immunovant, Inc.
IMXI|International Money Express, Inc.
INAB|IN8bio, Inc.
INAQ|Insight Acquisition Corp.
INAQU|Insight Acquisition Corp.
INAQW|Insight Acquisition Corp.
INBK|First Internet Bancorp
INBKZ|First Internet Bancorp
INBS|Intelligent Bio Solutions Inc.
INBX|Inhibrx Biosciences, Inc.
INCR|Intercure Ltd.
INCY|Incyte Corporation
INDB|Independent Bank Corp.
INDH|WisdomTree India Hedged Equity Fund
INDI|indie Semiconductor, Inc.
INDP|Indaptus Therapeutics, Inc.
INDV|Indivior PLC
INDY|iShares India 50 
INFN|Infinera Corporation
INFR|ClearBridge Sustainable Infrastructure 
INGN|Inogen, Inc
INHD|Inno Holdings Inc.
INKT|MiNK Therapeutics, Inc.
INM|InMed Pharmaceuticals Inc.
INMB|INmune Bio Inc.
INMD|InMode Ltd.
INNV|InnovAge Holding Corp.
INO|Inovio Pharmaceuticals, Inc.
INOD|Innodata Inc.
INRO|iShares U.S. Industry Rotation Active 
INSE|Inspired Entertainment, Inc.
INSG|Inseego Corp.
INSM|Insmed Incorporated
INTA|Intapp, Inc.
INTC|Intel Corporation
INTG|The Intergroup Corporation
INTJ|Intelligent Group Limited
INTR|Inter & Co. Inc.
INTS|Intensity Therapeutics, Inc.
INTU|Intuit Inc.
INTZ|Intrusion Inc.
INV|Innventure, Inc.
INVA|Innoviva, Inc.
INVE|Identiv, Inc.
INVZ|Innoviz Technologies Ltd.
INVZW|Innoviz Technologies Ltd.
INZY|Inozyme Pharma, Inc.
IOBT|IO Biotech, Inc.
IONR|ioneer Ltd
IONS|Ionis Pharmaceuticals, Inc.
IOSP|Innospec Inc.
IOVA|Iovance Biotherapeutics, Inc.
IPA|ImmunoPrecise Antibodies Ltd.
IPAR|Interparfums, Inc.
IPDN|Professional Diversity Network, Inc.
IPGP|IPG Photonics Corporation
IPHA|Innate Pharma S.A.
IPKW|Invesco International BuyBack Achievers 
IPSC|Century Therapeutics, Inc.
IPW|iPower Inc.
IPWR|Ideal Power Inc.
IPX|IperionX Limited
IPXX|Inflection Point Acquisition Corp. II
IPXXU|Inflection Point Acquisition Corp. II
IPXXW|Inflection Point Acquisition Corp. II
IQ|iQIYI, Inc.
IQQQ|ProShares Nasdaq
IRBT|iRobot Corporation
IRD|Opus Genetics, Inc.
IRDM|Iridium Communications Inc
IREN|Iris Energy Limited
IRIX|IRIDEX Corporation
IRMD|iRadimed Corporation
IROH|Iron Horse Acquisitions Corp.
IROHR|Iron Horse Acquisitions Corp.
IROHU|Iron Horse Acquisitions Corp.
IROHW|Iron Horse Acquisitions Corp.
IRON|Disc Medicine, Inc.
IROQ|IF Bancorp, Inc.
IRTC|iRhythm Technologies, Inc.
IRWD|Ironwood Pharmaceuticals, Inc.
ISHG|iShares 1
ISHP|First Trust S
ISPC|iSpecimen Inc.
ISPO|Inspirato Incorporated
ISPOW|Inspirato Incorporated
ISPR|Ispire Technology Inc.
ISRG|Intuitive Surgical, Inc.
ISRL|Israel Acquisitions Corp
ISRLU|Israel Acquisitions Corp
ISRLW|Israel Acquisitions Corp
ISSC|Innovative Solutions and Support, Inc.
ISTB|iShares Core 1
ISTR|Investar Holding Corporation
ITCI|Intra
ITIC|Investors Title Company
ITOS|iTeos Therapeutics, Inc.
ITRI|Itron, Inc.
ITRM|Iterum Therapeutics plc
ITRN|Ituran Location and Control Ltd.
IUS|Invesco RAFI Strategic US 
IUSB|iShares Core Total USD Bond Market 
IUSG|iShares Core S&P U.S. Growth 
IUSV|iShares Core S&P U.S. Value 
IVA|Inventiva S.A.
IVAC|Intevac, Inc.
IVAL|Alpha Architect International Quantitative Value 
IVCA|Investcorp AI Acquisition Corp.
IVCAU|Investcorp AI Acquisition Corp.
IVCAW|Investcorp AI Acquisition Corp.
IVCB|Investcorp Europe Acquisition Corp I
IVCBU|Investcorp Europe Acquisition Corp I
IVCBW|Investcorp Europe Acquisition Corp I
IVCP|Swiftmerge Acquisition Corp.
IVCPU|Swiftmerge Acquisition Corp.
IVCPW|Swiftmerge Acquisition Corp.
IVDA|Iveda Solutions, Inc.
IVDAW|Iveda Solutions, Inc.
IVEG|iShares Emergent Food and AgTech Multisector 
IVP|Inspire Veterinary Partners, Inc.
IVVD|Invivyd, Inc.
IWTR|iShares MSCI Water Management Multisector 
IXHL|Incannex Healthcare Inc.
IXUS|iShares Core MSCI Total International Stock 
IZEA|IZEA Worldwide, Inc.
IZM|ICZOOM Group Inc.
IZTC|Invizyne Technologies Inc.
JACK|Jack In The Box Inc.
JAGX|Jaguar Health, Inc.
JAKK|JAKKS Pacific, Inc.
JAMF|Jamf Holding Corp.
JANX|Janux Therapeutics, Inc.
JAZZ|Jazz Pharmaceuticals plc
JBDI|JBDI Holdings Limited
JBHT|J.B. Hunt Transport Services, Inc.
JBLU|JetBlue Airways Corporation
JBSS|John B. Sanfilippo & Son, Inc.
JCSE|JE Cleantech Holdings Limited
JCTC|Jewett
JD|JD.com, Inc.
JDOC|JPMorgan Healthcare Leaders 
JDZG|JIADE LIMITED
JEPQ|JPMorgan Nasdaq Equity Premium Income 
JFBR|Jeffs' Brands Ltd
JFBRW|Jeffs' Brands Ltd
JFIN|Jiayin Group Inc.
JFU|9F Inc.
JG|Aurora Mobile Limited
JGLO|JPMorgan Global Select Equity 
JIVE|JPMorgan International Value 
JJSF|J & J Snack Foods Corp.
JKHY|Jack Henry & Associates, Inc.
JL|J
JMID|Janus Henderson Mid Cap Growth Alpha 
JMSB|John Marshall Bancorp, Inc.
JNVR|Janover Inc.
JOUT|Johnson Outdoors Inc.
JPEF|JPMorgan Equity Focus 
JRSH|Jerash Holdings (US), Inc.
JRVR|James River Group Holdings, Ltd.
JSM|Navient Corporation
JSMD|Janus Henderson Small/Mid Cap Growth Alpha 
JSML|Janus Henderson Small Cap Growth Alpha 
JSPR|Jasper Therapeutics, Inc.
JSPRW|Jasper Therapeutics, Inc.
JTAI|Jet.AI Inc.
JTEK|JPMorgan U.S. Tech Leaders 
JUNE|Junee Limited
JVA|Coffee Holding Co., Inc.
JVSA|JVSPAC Acquisition Corp.
JVSAR|JVSPAC Acquisition Corp.
JVSAU|JVSPAC Acquisition Corp.
JWEL|Jowell Global Ltd.
JXJT|JX Luxventure Limited
JYD|Jayud Global Logistics Limited
JYNT|The Joint Corp.
JZ|Jianzhi Education Technology Group Company Limited
JZXN|Jiuzi Holdings, Inc.
KACL|Kairous Acquisition Corp. Limited
KACLR|Kairous Acquisition Corp. Limited
KACLU|Kairous Acquisition Corp. Limited
KACLW|Kairous Acquisition Corp. Limited
KALA|KALA BIO, Inc.
KALU|Kaiser Aluminum Corporation
KALV|KalVista Pharmaceuticals, Inc.
KARO|Karooooo Ltd.
KAVL|Kaival Brands Innovations Group, Inc.
KBWB|Invesco KBW Bank 
KBWD|Invesco KBW High Dividend Yield Financial 
KBWP|Invesco KBW Property & Casualty Insurance 
KBWR|Invesco KBW Regional Banking 
KBWY|Invesco KBW Premium Yield Equity REIT 
KC|Kingsoft Cloud Holdings Limited
KDLY|Kindly MD, Inc.
KDLYW|Kindly MD, Inc.
KDP|Keurig Dr Pepper Inc.
KE|Kimball Electronics, Inc.
KEAT|Keating Active 
KELYA|Kelly Services, Inc.
KELYB|Kelly Services, Inc.
KEQU|Kewaunee Scientific Corporation
KFFB|Kentucky First Federal Bancorp
KGEI|Kolibri Global Energy Inc.
KHC|The Kraft Heinz Company
KIDS|OrthoPediatrics Corp.
KINS|Kingstone Companies, Inc
KIRK|Kirkland's, Inc.
KITT|Nauticus Robotics, Inc.
KITTW|Nauticus Robotics, Inc.
KLAC|KLA Corporation
KLIC|Kulicke and Soffa Industries, Inc.
KLTO|Klotho Neurosciences, Inc.
KLTOW|Klotho Neurosciences, Inc.
KLTR|Kaltura, Inc.
KLXE|KLX Energy Services Holdings, Inc.
KMDA|Kamada Ltd.
KNDI|Kandi Technologies Group, Inc.
KNGZ|First Trust S&P 500 Diversified Dividend Aristocrats 
KNSA|Kiniksa Pharmaceuticals, Ltd.
KOD|Kodiak Sciences Inc
KOPN|Kopin Corporation
KOSS|Koss Corporation
KPLT|Katapult Holdings, Inc.
KPLTW|Katapult Holdings, Inc.
KPRX|Kiora Pharmaceuticals, Inc.
KPTI|Karyopharm Therapeutics Inc.
KQQQ|Kurv Technology Titans Select 
KRKR|36Kr Holdings Inc.
KRMA|Global X Conscious Companies 
KRMD|KORU Medical Systems, Inc.
KRNT|Kornit Digital Ltd.
KRNY|Kearny Financial
KRON|Kronos Bio, Inc.
KROP|Global X AgTech & Food Innovation 
KROS|Keros Therapeutics, Inc.
KRRO|Korro Bio, Inc.
KRT|Karat Packaging Inc.
KRUS|Kura Sushi USA, Inc.
KRYS|Krystal Biotech, Inc.
KSCP|Knightscope, Inc.
KSPI|Joint Stock Company Kaspi.kz
KTCC|Key Tronic Corporation
KTOS|Kratos Defense & Security Solutions, Inc.
KTTA|Pasithea Therapeutics Corp.
KTTAW|Pasithea Therapeutics Corp.
KURA|Kura Oncology, Inc.
KVAC|Keen Vision Acquisition Corporation
KVACU|Keen Vision Acquisition Corporation
KVACW|Keen Vision Acquisition Corporation
KVHI|KVH Industries, Inc.
KWE|KWESST Micro Systems Inc.
KWESW|KWESST Micro Systems Inc.
KXIN|Kaixin Holdings
KYMR|Kymera Therapeutics, Inc.
KYTX|Kyverna Therapeutics, Inc.
KZIA|Kazia Therapeutics Limited
KZR|Kezar Life Sciences, Inc.
LAB|Standard BioTools Inc.
LAES|SEALSQ Corp
LAKE|Lakeland Industries, Inc.
LAMR|Lamar Advertising Company
LANC|Lancaster Colony Corporation
LAND|Gladstone Land Corporation
LANDM|Gladstone Land Corporation
LANDO|Gladstone Land Corporation
LANDP|Gladstone Land Corporation
LARK|Landmark Bancorp Inc.
LASE|Laser Photonics Corporation
LASR|nLIGHT, Inc.
LATG|Chenghe Acquisition I Co.
LATGU|Chenghe Acquisition I Co.
LAUR|Laureate Education, Inc.
LAZR|Luminar Technologies, Inc.
LBGJ|Li Bang International Corporation Inc.
LBPH|Longboard Pharmaceuticals, Inc.
LBRDA|Liberty Broadband Corporation
LBRDK|Liberty Broadband Corporation
LBRDP|Liberty Broadband Corporation
LBTYA|Liberty Global Ltd.
LBTYB|Liberty Global Ltd.
LBTYK|Liberty Global Ltd.
LCDS|JPMorgan Fundamental Data Science Large Core 
LCFY|Locafy Limited
LCFYW|Locafy Limited
LCID|Lucid Group, Inc.
LCNB|LCNB Corporation
LCUT|Lifetime Brands, Inc.
LDEM|iShares ESG MSCI EM Leaders 
LDSF|First Trust Low Duration Strategic Focus 
LDTC|LeddarTech Holdings Inc.
LDTCW|LeddarTech Holdings Inc.
LDWY|Lendway, Inc.
LE|Lands' End, Inc.
LECO|Lincoln Electric Holdings, Inc.
LEDS|SemiLEDS Corporation
LEE|Lee Enterprises, Incorporated
LEGH|Legacy Housing Corporation
LEGN|Legend Biotech Corporation
LEGR|First Trust Indxx Innovative Transaction & Process 
LENZ|LENZ Therapeutics, Inc.
LESL|Leslie's, Inc.
LEXX|Lexaria Bioscience Corp.
LEXXW|Lexaria Bioscience Corp.
LFCR|Lifecore Biomedical, Inc.
LFLY|Leafly Holdings, Inc.
LFLYW|Leafly Holdings, Inc.
LFMD|LifeMD, Inc.
LFMDP|LifeMD, Inc.
LFSC|F/m Emerald Life Sciences Innovation 
LFST|LifeStance Health Group, Inc.
LFUS|Littelfuse, Inc.
LFVN|Lifevantage Corporation
LFWD|Lifeward Ltd.
LGCB|Linkage Global Inc
LGCL|Lucas GC Limited
LGHL|Lion Group Holding Ltd.
LGHLW|Lion Group Holding Ltd.
LGIH|LGI Homes, Inc.
LGMK|LogicMark, Inc.
LGND|Ligand Pharmaceuticals Incorporated
LGO|Largo Inc.
LGRO|Level Four Large Cap Growth Active 
LGTY|Logility Supply Chain Solutions, Inc.
LGVN|Longeveron Inc.
LI|Li Auto Inc.
LICN|Lichen China Limited
LIDR|AEye, Inc.
LIDRW|AEye, Inc.
LIEN|Chicago Atlantic BDC, Inc.
LIF|Life360, Inc.
LIFW|MSP Recovery, Inc.
LIFWW|MSP Recovery, Inc.
LIFWZ|MSP Recovery, Inc.
LILA|Liberty Latin America Ltd.
LILAK|Liberty Latin America Ltd.
LIN|Linde plc
LINC|Lincoln Educational Services Corporation
LIND|Lindblad Expeditions Holdings Inc.
LINE|Lineage, Inc.
LINK|Interlink Electronics, Inc.
LION|Lionsgate Studios Corp.
LIPO|Lipella Pharmaceuticals Inc.
LIQT|LiqTech International, Inc.
LITE|Lumentum Holdings Inc.
LITM|Snow Lake Resources Ltd.
LITP|Sprott Lithium Miners 
LIVE|Live Ventures Incorporated
LIVN|LivaNova PLC
LIVR|Intelligent Livermore 
LIXT|Lixte Biotechnology Holdings, Inc.
LIXTW|Lixte Biotechnology Holdings, Inc.
LKCO|Luokung Technology Corp
LKFN|Lakeland Financial Corporation
LKQ|LKQ Corporation
LLYVA|Liberty Media Corporation
LLYVK|Liberty Media Corporation
LMAT|LeMaitre Vascular, Inc.
LMB|Limbach Holdings, Inc.
LMBS|First Trust Low Duration Opportunities 
LMFA|LM Funding America, Inc.
LMNR|Limoneira Co
LNKB|LINKBANCORP, Inc.
LNSR|LENSAR, Inc.
LNT|Alliant Energy Corporation
LNTH|Lantheus Holdings, Inc.
LNW|Light & Wonder, Inc.
LNZA|LanzaTech Global, Inc.
LNZAW|LanzaTech Global, Inc.
LOAN|Manhattan Bridge Capital, Inc
LOBO|LOBO EV TECHNOLOGIES LTD.
LOCO|El Pollo Loco Holdings, Inc.
LOGC|ContextLogic Inc.
LOGI|Logitech International S.A.
LOOP|Loop Industries, Inc.
LOPE|Grand Canyon Education, Inc.
LOT|Lotus Technology Inc.
LOTWW|Lotus Technology Inc.
LOVE|The Lovesac Company
LPAA|Launch One Acquisition Corp.
LPAAU|Launch One Acquisition Corp.
LPAAW|Launch One Acquisition Corp.
LPBBU|Launch Two Acquisition Corp.
LPCN|Lipocine Inc.
LPLA|LPL Financial Holdings Inc.
LPRO|Open Lending Corporation
LPSN|LivePerson, Inc.
LPTH|LightPath Technologies, Inc.
LPTX|Leap Therapeutics, Inc.
LQDA|Liquidia Corporation
LQDT|Liquidity Services, Inc.
LQR|LQR House Inc.
LRCX|Lam Research Corporation
LRE|Lead Real Estate Co., Ltd
LRFC|Logan Ridge Finance Corporation
LRGE|ClearBridge Large Cap Growth ESG 
LRHC|La Rosa Holdings Corp.
LRMR|Larimar Therapeutics, Inc.
LRND|NYLI U.S. Large Cap R&D Leaders 
LSAK|Lesaka Technologies, Inc.
LSB|LakeShore Biopharma Co., Ltd
LSBK|Lake Shore Bancorp, Inc.
LSBPW|LakeShore Biopharma Co., Ltd
LSCC|Lattice Semiconductor Corporation
LSEA|Landsea Homes Corporation
LSEAW|Landsea Homes Corporation
LSH|Lakeside Holding Limited
LSTA|Lisata Therapeutics, Inc.
LSTR|Landstar System, Inc.
LTBR|Lightbridge Corporation
LTRN|Lantern Pharma Inc.
LTRX|Lantronix, Inc.
LTRY|Lottery.com, Inc.
LTRYW|Lottery.com, Inc.
LUCD|Lucid Diagnostics Inc.
LUCY|Innovative Eyewear, Inc.
LUCYW|Innovative Eyewear, Inc.
LULU|lululemon athletica inc.
LUMO|Lumos Pharma, Inc.
LUNA|Luna Innovations Incorporated
LUNG|Pulmonx Corporation
LUNR|Intuitive Machines, Inc.
LUNRW|Intuitive Machines, Inc.
LUXH|LuxUrban Hotels Inc.
LUXHP|LuxUrban Hotels Inc.
LVHD|Franklin U.S. Low Volatility High Dividend Index 
LVLU|Lulu's Fashion Lounge Holdings, Inc.
LVO|LiveOne, Inc.
LVRO|Lavoro Limited
LVROW|Lavoro Limited
LVTX|LAVA Therapeutics N.V.
LWAY|Lifeway Foods, Inc.
LWLG|Lightwave Logic, Inc.
LX|LexinFintech Holdings Ltd.
LXEH|Lixiang Education Holding Co., Ltd.
LXEO|Lexeo Therapeutics, Inc.
LXRX|Lexicon Pharmaceuticals, Inc.
LYEL|Lyell Immunopharma, Inc.
LYFT|Lyft, Inc.
LYRA|Lyra Therapeutics, Inc.
LYT|Lytus Technologies Holdings PTV. Ltd.
LYTS|LSI Industries Inc.
LZ|LegalZoom.com, Inc.
MACI|Melar Acquisition Corp. I
MACIU|Melar Acquisition Corp. I
MACIW|Melar Acquisition Corp. I
MAGQ|Roundhill Daily Inverse Magnificent Seven 
MAGS|Roundhill Magnificent Seven 
MAGX|Roundhill Daily  Long Magnificent Seven 
MAMA|Mama's Creations, Inc.
MAMO|Massimo Group
MANH|Manhattan Associates, Inc.
MAPS|WM Technology, Inc.
MAPSW|WM Technology, Inc.
MAR|Marriott International
MARA|MARA Holdings, Inc.
MARPS|Marine Petroleum Trust
MARX|Mars Acquisition Corp.
MARXR|Mars Acquisition Corp.
MARXU|Mars Acquisition Corp.
MASI|Masimo Corporation
MASS|908 Devices Inc.
MAT|Mattel, Inc.
MATH|Metalpha Technology Holding Limited
MATW|Matthews International Corporation
MAXI|Simplify Bitcoin Strategy PLUS Income 
MAXN|Maxeon Solar Technologies, Ltd.
MAYS|J. W. Mays, Inc.
MBAV|M3
MBAVU|M3
MBAVW|M3
MBB|iShares MBS 
MBCN|Middlefield Banc Corp.
MBIN|Merchants Bancorp
MBINM|Merchants Bancorp
MBINN|Merchants Bancorp
MBINO|Merchants Bancorp
MBIO|Mustang Bio, Inc.
MBLY|Mobileye Global Inc.
MBNKP|Medallion Bank
MBOT|Microbot Medical Inc.
MBRX|Moleculin Biotech, Inc.
MBUU|Malibu Boats, Inc.
MBWM|Mercantile Bank Corporation
MBX|MBX Biosciences, Inc.
MCBS|MetroCity Bankshares, Inc.
MCDS|JPMorgan Fundamental Data Science Mid Core 
MCFT|MasterCraft Boat Holdings, Inc.
MCHI|iShares MSCI China 
MCHP|Microchip Technology Incorporated
MCHS|Matthews China Discovery Active 
MCHX|Marchex, Inc.
MCRB|Seres Therapeutics, Inc.
MCRI|Monarch Casino & Resort, Inc.
MCSE|Martin Currie Sustainable International Equity 
MCVT|Mill City Ventures III, Ltd.
MDAI|Spectral AI, Inc.
MDAIW|Spectral AI, Inc.
MDB|MongoDB, Inc.
MDBH|MDB Capital Holdings, LLC
MDCP|VictoryShares THB Mid Cap 
MDCX|Medicus Pharma Ltd.
MDCXW|Medicus Pharma Ltd.
MDGL|Madrigal Pharmaceuticals, Inc.
MDIA|Mediaco Holding Inc.
MDIV|Multi
MDJH|MDJM LTD
MDLZ|Mondelez International, Inc.
MDRR|Medalist Diversified REIT, Inc.
MDRRP|Medalist Diversified REIT, Inc.
MDWD|MediWound Ltd.
MDXG|MiMedx Group, Inc
MDXH|MDxHealth SA
ME|23andMe Holding Co.
MEDP|Medpace Holdings, Inc.
MEDX|Horizon Kinetics Medical 
MEGL|Magic Empire Global Limited
MEIP|MEI Pharma, Inc.
MELI|MercadoLibre, Inc.
MEMS|Matthews Emerging Markets Discovery Active 
MEOH|Methanex Corporation
MERC|Mercer International Inc.
MESA|Mesa Air Group, Inc.
MESO|Mesoblast Limited
META|Meta Platforms, Inc.
METC|Ramaco Resources, Inc.
METCB|Ramaco Resources, Inc.
METCL|Ramaco Resources, Inc.
MFH|Mercurity Fintech Holding Inc.
MFI|mF International Limited
MFIC|MidCap Financial Investment Corporation
MFICL|MidCap Financial Investment Corporation
MFIN|Medallion Financial Corp.
MFLX|First Trust Flexible Municipal High Income 
MGEE|MGE Energy Inc.
MGIC|Magic Software Enterprises Ltd.
MGIH|Millennium Group International Holdings Limited
MGNI|Magnite, Inc.
MGNX|MacroGenics, Inc.
MGOL|MGO Global Inc.
MGPI|MGP Ingredients, Inc.
MGRC|McGrath RentCorp
MGRM|Monogram Technologies Inc.
MGRX|Mangoceuticals, Inc.
MGTX|MeiraGTx Holdings plc
MGX|Metagenomi, Inc.
MGYR|Magyar Bancorp, Inc.
MHLD|Maiden Holdings, Ltd.
MHUA|Meihua International Medical Technologies Co., Ltd.
MIDD|The Middleby Corporation
MIGI|Mawson Infrastructure Group Inc.
MILN|Global X Millennial Consumer 
MIND|MIND Technology, Inc.
MIRA|MIRA Pharmaceuticals, Inc.
MIRM|Mirum Pharmaceuticals, Inc.
MIST|Milestone Pharmaceuticals Inc.
MITA|Coliseum Acquisition Corp.
MITAU|Coliseum Acquisition Corp.
MITAW|Coliseum Acquisition Corp.
MITK|Mitek Systems, Inc.
MKAM|MKAM 
MKDW|MKDWELL Tech Inc.
MKDWW|MKDWELL Tech Inc.
MKSI|MKS Instruments, Inc.
MKTW|MarketWise, Inc.
MKTX|MarketAxess Holdings, Inc.
MKZR|MacKenzie Realty Capital, Inc.
MLAB|Mesa Laboratories, Inc.
MLCO|Melco Resorts & Entertainment Limited
MLEC|Moolec Science SA
MLECW|Moolec Science SA
MLGO|MicroAlgo, Inc.
MLKN|MillerKnoll, Inc.
MLTX|MoonLake Immunotherapeutics
MLYS|Mineralys Therapeutics, Inc.
MMLP|Martin Midstream Partners L.P.
MMSI|Merit Medical Systems, Inc.
MMV|MultiMetaVerse Holdings Limited
MMVWW|MultiMetaVerse Holdings Limited
MMYT|MakeMyTrip Limited
MNDO|MIND C.T.I. Ltd.
MNDR|Mobile
MNDY|monday.com Ltd.
MNKD|MannKind Corporation
MNMD|Mind Medicine (MindMed) Inc.
MNOV|MediciNova, Inc.
MNPR|Monopar Therapeutics Inc.
MNRO|Monro, Inc.
MNSB|MainStreet Bancshares, Inc.
MNSBP|MainStreet Bancshares, Inc.
MNST|Monster Beverage Corporation
MNTK|Montauk Renewables, Inc.
MNTL|Tema Neuroscience and Mental Health 
MNTS|Momentus Inc.
MNTSW|Momentus Inc.
MNTX|Manitex International, Inc.
MNY|MoneyHero Limited
MNYWW|MoneyHero Limited
MOB|Mobilicom Limited
MOBBW|Mobilicom Limited
MOBX|Mobix Labs, Inc.
MOBXW|Mobix Labs, Inc.
MODD|Modular Medical, Inc.
MODL|VictoryShares WestEnd U.S. Sector 
MODV|ModivCare Inc.
MOFG|MidWestOne Financial Group, Inc.
MOGO|Mogo Inc.
MOLN|Molecular Partners AG
MOMO|Hello Group Inc.
MOND|Mondee Holdings, Inc.
MOOD|Relative Sentiment Tactical Allocation 
MORN|Morningstar, Inc.
MOVE|Movano Inc.
MPAA|Motorcar Parts of America, Inc.
MPB|Mid Penn Bancorp
MPWR|Monolithic Power Systems, Inc.
MQ|Marqeta, Inc.
MQQQ|Tradr  Long Triple Q Monthly 
MRAM|Everspin Technologies, Inc.
MRBK|Meridian Corporation
MRCC|Monroe Capital Corporation
MRCY|Mercury Systems Inc
MREO|Mereo BioPharma Group plc
MRIN|Marin Software Incorporated
MRKR|Marker Therapeutics, Inc.
MRM|MEDIROM Healthcare Technologies Inc.
MRNA|Moderna, Inc.
MRNO|Murano Global Investments PLC
MRNOW|Murano Global Investments PLC
MRNS|Marinus Pharmaceuticals, Inc.
MRSN|Mersana Therapeutics, Inc.
MRTN|Marten Transport, Ltd.
MRUS|Merus N.V.
MRVI|Maravai LifeSciences Holdings, Inc.
MRVL|Marvell Technology, Inc.
MRX|Marex Group plc
MSAI|MultiSensor AI Holdings, Inc.
MSAIW|MultiSensor AI Holdings, Inc.
MSBI|Midland States Bancorp, Inc.
MSBIP|Midland States Bancorp, Inc.
MSEX|Middlesex Water Company
MSFL|GraniteShares  Long MSFT Daily 
MSFT|Microsoft Corporation
MSGM|Motorsport Games Inc.
MSS|Maison Solutions Inc.
MSSA|Metal Sky Star Acquisition Corporation
MSSAR|Metal Sky Star Acquisition Corporation
MSSAU|Metal Sky Star Acquisition Corporation
MSSAW|Metal Sky Star Acquisition Corporation
MSTR|MicroStrategy Incorporated
MSTX|Defiance Daily Target  Long MSTR 
MSW|Ming Shing Group Holdings Limited
MTC|MMTec, Inc.
MTCH|Match Group, Inc.
MTEK|Maris
MTEKW|Maris
MTEM|Molecular Templates, Inc.
MTEN|Mingteng International Corporation Inc.
MTEX|Mannatech, Incorporated
MTLS|Materialise NV
MTRX|Matrix Service Company
MTSI|MACOM Technology Solutions Holdings, Inc.
MTTR|Matterport, Inc.
MU|Micron Technology, Inc.
MULL|GraniteShares  Long MU Daily 
MULN|Mullen Automotive, Inc.
MURA|Mural Oncology plc
MVBF|MVB Financial Corp.
MVIS|MicroVision, Inc.
MVST|Microvast Holdings, Inc.
MVSTW|Microvast Holdings, Inc.
MXCT|MaxCyte, Inc.
MXL|MaxLinear, Inc
MYFW|First Western Financial, Inc.
MYGN|Myriad Genetics, Inc.
MYNA|Mynaric AG
MYNZ|Mainz Biomed N.V.
MYPS|PLAYSTUDIOS, Inc.
MYPSW|PLAYSTUDIOS, Inc.
MYRG|MYR Group, Inc.
MYSZ|My Size, Inc.
NA|Nano Labs Ltd
NAAS|NaaS Technology Inc.
NAII|Natural Alternatives International, Inc.
NAMS|NewAmsterdam Pharma Company N.V.
NAMSW|NewAmsterdam Pharma Company N.V.
NAOV|NanoVibronix, Inc.
NARI|Inari Medical, Inc.
NATH|Nathan's Famous, Inc.
NATO|Themes Transatlantic Defense 
NATR|Nature's Sunshine Products, Inc.
NAUT|Nautilus Biotechnology, Inc.
NAVI|Navient Corporation
NAYA|NAYA Biosciences, Inc.
NB|NioCorp Developments Ltd.
NBBK|NB Bancorp, Inc.
NBIS|Nebius Group N.V.
NBIX|Neurocrine Biosciences, Inc.
NBN|Northeast Bank
NBTB|NBT Bancorp Inc.
NBTX|Nanobiotix S.A.
NCI|Neo
NCMI|National CineMedia, Inc.
NCNA|NuCana plc
NCNC|noco
NCNCW|noco
NCNO|nCino, Inc.
NCPB|Nuveen Core Plus Bond 
NCPL|Netcapital Inc.
NCPLW|Netcapital Inc.
NCRA|Nocera, Inc.
NCSM|NCS Multistage Holdings, Inc.
NCTY|The9 Limited
NDAA|Ned Davis Research 360 Dynamic Allocation 
NDAQ|Nasdaq, Inc.
NDLS|Noodles & Company
NDRA|ENDRA Life Sciences Inc.
NDSN|Nordson Corporation
NECB|NorthEast Community Bancorp, Inc.
NEGG|Newegg Commerce, Inc.
NEO|NeoGenomics, Inc.
NEOG|Neogen Corporation
NEON|Neonode Inc.
NEOV|NeoVolta Inc.
NEOVW|NeoVolta Inc.
NEPH|Nephros, Inc.
NERD|Roundhill Video Games 
NERV|Minerva Neurosciences, Inc
NESR|National Energy Services Reunited Corp
NESRW|National Energy Services Reunited Corp
NETD|Nabors Energy Transition Corp. II
NETDU|Nabors Energy Transition Corp. II
NETDW|Nabors Energy Transition Corp. II
NEWT|NewtekOne, Inc.
NEWTG|NewtekOne, Inc.
NEWTH|NewtekOne, Inc.
NEWTI|NewtekOne, Inc.
NEWTZ|NewtekOne, Inc.
NEWZ|StockSnips AI
NEXN|Nexxen International Ltd.
NEXT|NextDecade Corporation
NFBK|Northfield Bancorp, Inc.
NFE|New Fortress Energy Inc.
NFLX|Netflix, Inc.
NFTY|First Trust India Nifty 50 Equal Weight 
NGNE|Neurogene Inc.
NHTC|Natural Health Trends Corp.
NICE|NICE Ltd
NIKL|Sprott Nickel Miners 
NIOBW|NioCorp Developments Ltd.
NIPG|NIP Group Inc.
NISN|NiSun Intl Enterprise Development Group Co, Ltd
NITO|N2OFF, Inc.
NIU|Niu Technologies
NIVF|NewGenIvf Group Limited
NIVFW|NewGenIvf Group Limited
NIXT|Research Affiliates Deletions 
NIXX|Nixxy, Inc.
NIXXW|Nixxy, Inc.
NKGN|NKGen Biotech, Inc.
NKGNW|NKGen Biotech, Inc.
NKLA|Nikola Corporation
NKSH|National Bankshares, Inc.
NKTR|Nektar Therapeutics
NKTX|Nkarta, Inc.
NLSP|NLS Pharmaceutics Ltd.
NLSPW|NLS Pharmaceutics Ltd.
NMFC|New Mountain Finance Corporation
NMFCZ|New Mountain Finance Corporation
NMHI|Nature's Miracle Holding Inc.
NMHIW|Nature's Miracle Holding Inc.
NMIH|NMI Holdings Inc
NMRA|Neumora Therapeutics, Inc.
NMRK|Newmark Group, Inc.
NMTC|NeuroOne Medical Technologies Corporation
NN|NextNav Inc.
NNAVW|NextNav Inc.
NNBR|NN, Inc.
NNDM|Nano Dimension Ltd.
NNE|Nano Nuclear Energy Inc.
NNOX|NANO
NODK|NI Holdings, Inc.
NOEMU|CO2 Energy Transition Corp.
NOTV|Inotiv, Inc.
NOVT|Novanta Inc.
NPCE|Neuropace, Inc.
NPFI|Nuveen Preferred and Income 
NRBO|NeuroBo Pharmaceuticals, Inc.
NRC|National Research Corporation
NRDS|NerdWallet, Inc.
NRES|Xtrackers RREEF Global Natural Resources 
NRIM|Northrim BanCorp Inc
NRIX|Nurix Therapeutics, Inc.
NRSN|NeuroSense Therapeutics Ltd.
NRSNW|NeuroSense Therapeutics Ltd.
NRXP|NRX Pharmaceuticals, Inc.
NRXPW|NRX Pharmaceuticals, Inc.
NSCR|Nuveen Sustainable Core 
NSI|National Security Emerging Markets Index 
NSIT|Insight Enterprises, Inc.
NSPR|InspireMD Inc.
NSSC|NAPCO Security Technologies, Inc.
NSTS|NSTS Bancorp, Inc.
NSYS|Nortech Systems Incorporated
NTAP|NetApp, Inc.
NTCT|NetScout Systems, Inc.
NTES|NetEase, Inc.
NTGR|NETGEAR, Inc.
NTIC|Northern Technologies International Corporation
NTLA|Intellia Therapeutics, Inc.
NTNX|Nutanix, Inc.
NTRA|Natera, Inc.
NTRB|Nutriband Inc.
NTRBW|Nutriband Inc.
NTRP|NextTrip, Inc.
NTRS|Northern Trust Corporation
NTRSO|Northern Trust Corporation
NTWK|NETSOL Technologies Inc.
NTWOU|Newbury Street II Acquisition Corp
NUKK|Nukkleus Inc.
NUKKW|Nukkleus Inc.
NURO|NeuroMetrix, Inc.
NUSB|Nuveen Ultra Short Income 
NUTX|Nutex Health Inc.
NUVL|Nuvalent, Inc.
NUWE|Nuwellis, Inc.
NVA|Nova Minerals Limited
NVAC|NorthView Acquisition Corporation
NVACR|NorthView Acquisition Corporation
NVACW|NorthView Acquisition Corporation
NVAWW|Nova Minerals Limited
NVAX|Novavax, Inc.
NVCR|NovoCure Limited
NVCT|Nuvectis Pharma, Inc.
NVD|GraniteShares  Short NVDA Daily 
NVDA|NVIDIA Corporation
NVDL|GraniteShares  Long NVDA Daily 
NVDS|Tradr  Short NVDA Daily 
NVDW|Tradr  Long NVDA Weekly 
NVEC|NVE Corporation
NVEE|NV5 Global, Inc.
NVFY|Nova Lifestyle, Inc
NVMI|Nova Ltd.
NVNI|Nvni Group Limited
NVNIW|Nvni Group Limited
NVNO|enVVeno Medical Corporation
NVTS|Navitas Semiconductor Corporation
NVVE|Nuvve Holding Corp.
NVVEW|Nuvve Holding Corp.
NVX|NOVONIX Limited
NWBI|Northwest Bancshares, Inc.
NWE|NorthWestern Energy Group, Inc.
NWFL|Norwood Financial Corp.
NWGL|Nature Wood Group Limited
NWL|Newell Brands Inc.
NWPX|Northwest Pipe Company
NWS|News Corporation
NWSA|News Corporation
NWTN|NWTN Inc.
NWTNW|NWTN Inc.
NXGL|NexGel, Inc
NXGLW|NexGel, Inc
NXL|Nexalin Technology, Inc.
NXLIW|Nexalin Technology, Inc.
NXPI|NXP Semiconductors N.V.
NXPL|NextPlat Corp
NXPLW|NextPlat Corp
NXST|Nexstar Media Group, Inc.
NXT|Nextracker Inc.
NXTC|NextCure, Inc.
NXTG|First Trust Indxx NextG 
NXTT|Next Technology Holding Inc.
NXU|Nxu, Inc.
NYAX|Nayax Ltd.
NYMT|New York Mortgage Trust, Inc.
NYMTI|New York Mortgage Trust, Inc.
NYMTL|New York Mortgage Trust, Inc.
NYMTM|New York Mortgage Trust, Inc.
NYMTN|New York Mortgage Trust, Inc.
NYMTZ|New York Mortgage Trust, Inc.
NYXH|Nyxoah SA
NZAC|SPDR MSCI ACWI Climate Paris Aligned 
NZUS|SPDR MSCI USA Climate Paris Aligned 
OABI|OmniAb, Inc.
OABIW|OmniAb, Inc.
OACCU|Oaktree Acquisition Corp. III Life Sciences
OAKU|Oak Woods Acquisition Corporation
OAKUR|Oak Woods Acquisition Corporation
OAKUU|Oak Woods Acquisition Corporation
OAKUW|Oak Woods Acquisition Corporation
OB|Outbrain Inc.
OBIL|US Treasury 12 Month Bill 
OBIO|Orchestra BioMed Holdings, Inc.
OBLG|Oblong Inc.
OBT|Orange County Bancorp, Inc.
OCC|Optical Cable Corporation
OCCI|OFS Credit Company, Inc.
OCCIM|OFS Credit Company, Inc.
OCCIN|OFS Credit Company, Inc.
OCCIO|OFS Credit Company, Inc.
OCEA|Ocean Biomedical, Inc.
OCEAW|Ocean Biomedical, Inc.
OCFC|OceanFirst Financial Corp.
OCFCP|OceanFirst Financial Corp.
OCG|Oriental Culture Holding LTD
OCGN|Ocugen, Inc.
OCS|Oculis Holding AG
OCSAW|Oculis Holding AG
OCSL|Oaktree Specialty Lending Corporation
OCTA|Octane All
OCTO|Eightco Holdings Inc.
OCUL|Ocular Therapeutix, Inc.
OCX|Oncocyte Corporation
ODD|ODDITY Tech Ltd.
ODDS|Pacer BlueStar Digital Entertainment 
ODFL|Old Dominion Freight Line, Inc.
ODP|The ODP Corporation
ODVWZ|Osisko Development Corp.
OESX|Orion Energy Systems, Inc.
OFIX|Orthofix Medical Inc.
OFLX|Omega Flex, Inc.
OFS|OFS Capital Corporation
OFSSH|OFS Capital Corporation
OGI|Organigram Holdings Inc.
OKTA|Okta, Inc.
OKUR|OnKure Therapeutics, Inc.
OKYO|OKYO Pharma Limited
OLB|The OLB Group, Inc.
OLED|Universal Display Corporation
OLLI|Ollie's Bargain Outlet Holdings, Inc.
OLMA|Olema Pharmaceuticals, Inc.
OLPX|Olaplex Holdings, Inc.
OM|Outset Medical, Inc.
OMAB|Grupo Aeroportuario del Centro Norte S.A.B. de C.V.
OMCC|Old Market Capital Corporation
OMCL|Omnicell, Inc.
OMER|Omeros Corporation
OMEX|Odyssey Marine Exploration, Inc.
OMGA|Omega Therapeutics, Inc.
OMH|Ohmyhome Limited
OMIC|Singular Genomics Systems, Inc.
ON|ON Semiconductor Corporation
ONB|Old National Bancorp
ONBPO|Old National Bancorp
ONBPP|Old National Bancorp
ONCO|Onconetix, Inc.
ONCT|Oncternal Therapeutics, Inc.
ONCY|Oncolytics Biotech Inc.
ONDS|Ondas Holdings Inc.
ONEQ|Fidelity Nasdaq Composite Index 
ONEW|OneWater Marine Inc.
ONFO|Onfolio Holdings Inc.
ONFOW|Onfolio Holdings Inc.
ONMD|OneMedNet Corp
ONMDW|OneMedNet Corp
ONVO|Organovo Holdings, Inc.
OP|OceanPal Inc.
OPAL|OPAL Fuels Inc.
OPBK|OP Bancorp
OPCH|Option Care Health, Inc.
OPEN|Opendoor Technologies Inc
OPHC|OptimumBank Holdings, Inc.
OPI|Office Properties Income Trust
OPINL|Office Properties Income Trust
OPK|Opko Health, Inc.
OPOF|Old Point Financial Corporation
OPRA|Opera Limited
OPRT|Oportun Financial Corporation
OPRX|OptimizeRx Corporation
OPT|Opthea Limited
OPTN|OptiNose, Inc.
OPTX|Syntec Optics Holdings, Inc.
OPTXW|Syntec Optics Holdings, Inc.
OPTZ|Optimize Strategy Index 
OPXS|Optex Systems Holdings, Inc.
ORGN|Origin Materials, Inc.
ORGNW|Origin Materials, Inc.
ORGO|Organogenesis Holdings Inc.
ORIC|Oric Pharmaceuticals, Inc.
ORIS|Oriental Rise Holdings Limited
ORKA|Oruka Therapeutics, Inc.
ORKT|Orangekloud Technology Inc.
ORLY|O'Reilly Automotive, Inc.
ORMP|Oramed Pharmaceuticals Inc.
ORRF|Orrstown Financial Services Inc
OS|OneStream, Inc.
OSBC|Old Second Bancorp, Inc.
OSIS|OSI Systems, Inc.
OSPN|OneSpan Inc.
OSS|One Stop Systems, Inc.
OST|Ostin Technology Group Co., Ltd.
OSUR|OraSure Technologies, Inc.
OSW|OneSpaWorld Holdings Limited
OTEX|Open Text Corporation
OTLK|Outlook Therapeutics, Inc.
OTLY|Oatly Group AB
OTRK|Ontrak, Inc.
OTTR|Otter Tail Corporation
OVBC|Ohio Valley Banc Corp.
OVID|Ovid Therapeutics Inc.
OVLY|Oak Valley Bancorp (CA)
OXBR|Oxbridge Re Holdings Limited
OXBRW|Oxbridge Re Holdings Limited
OXLC|Oxford Lane Capital Corp.
OXLCI|Oxford Lane Capital Corp.
OXLCL|Oxford Lane Capital Corp.
OXLCN|Oxford Lane Capital Corp.
OXLCO|Oxford Lane Capital Corp.
OXLCP|Oxford Lane Capital Corp.
OXLCZ|Oxford Lane Capital Corp.
OXSQ|Oxford Square Capital Corp.
OXSQG|Oxford Square Capital Corp.
OXSQZ|Oxford Square Capital Corp.
OZEM|Roundhill GLP
OZK|Bank OZK
OZKAP|Bank OZK
PAA|Plains All American Pipeline, L.P.
PABD|iShares Paris
PABU|iShares Paris
PACB|Pacific Biosciences of California, Inc.
PAGP|Plains GP Holdings, L.P.
PAHC|Phibro Animal Health Corporation
PAL|Proficient Auto Logistics, Inc.
PALI|Palisade Bio, Inc.
PALT|Paltalk, Inc.
PAMT|PAMT CORP
PANL|Pangaea Logistics Solutions Ltd.
PANW|Palo Alto Networks, Inc.
PARA|Paramount Global
PARAA|Paramount Global
PASG|Passage Bio, Inc.
PATK|Patrick Industries, Inc.
PATN|Pacer Nasdaq International Patent Leaders 
PAVM|PAVmed Inc.
PAVMZ|PAVmed Inc.
PAVS|Paranovus Entertainment Technology Ltd.
PAX|Patria Investments Limited
PAYO|Payoneer Global Inc.
PAYS|Paysign, Inc.
PAYX|Paychex, Inc.
PBBK|PB Bankshares, Inc.
PBFS|Pioneer Bancorp, Inc.
PBHC|Pathfinder Bancorp, Inc.
PBM|Psyence Biomedical Ltd.
PBMWW|Psyence Biomedical Ltd.
PBPB|Potbelly Corporation
PBYI|Puma Biotechnology Inc
PC|Premium Catering (Holdings) Limited
PCAR|PACCAR Inc.
PCB|PCB Bancorp
PCH|PotlatchDeltic Corporation
PCRX|Pacira BioSciences, Inc.
PCSA|Processa Pharmaceuticals, Inc.
PCSC|Perceptive Capital Solutions Corp
PCT|PureCycle Technologies, Inc.
PCTTU|PureCycle Technologies, Inc.
PCTTW|PureCycle Technologies, Inc.
PCTY|Paylocity Holding Corporation
PCVX|Vaxcyte, Inc.
PCYO|Pure Cycle Corporation
PDBA|Invesco Agriculture Commodity Strategy No K
PDBC|Invesco Optimum Yield Diversified Commodity Strategy No K
PDCO|Patterson Companies, Inc.
PDD|PDD Holdings Inc.
PDEX|Pro
PDFS|PDF Solutions, Inc.
PDLB|Ponce Financial Group, Inc.
PDP|Invesco Dorsey Wright Momentum 
PDSB|PDS Biotechnology Corporation
PDYN|Palladyne AI Corp.
PDYNW|Palladyne AI Corp.
PEBK|Peoples Bancorp of North Carolina, Inc.
PEBO|Peoples Bancorp Inc.
PECO|Phillips Edison & Company, Inc.
PEGA|Pegasystems Inc.
PENG|Penguin Solutions, Inc.
PENN|PENN Entertainment, Inc.
PEP|PepsiCo, Inc.
PEPG|PepGen Inc.
PEPS|Parametric Equity Plus 
PERI|Perion Network Ltd
PESI|Perma
PET|Wag! Group Co.
PETS|PetMed Express, Inc.
PETWW|Wag! Group Co.
PETZ|TDH Holdings, Inc.
PEV|Phoenix Motor Inc.
PEY|Invesco High Yield Equity Dividend Achievers 
PEZ|Invesco Dorsey Wright Consumer Cyclicals Momentum 
PFBC|Preferred Bank
PFC|Premier Financial Corp.
PFF|iShares Preferred and Income Securities 
PFG|Principal Financial Group Inc
PFI|Invesco Dorsey Wright Financial Momentum 
PFIE|Profire Energy, Inc.
PFIS|Peoples Financial Services Corp.
PFM|Invesco Dividend Achievers 
PFMT|Performant Financial Corporation
PFTA|Perception Capital Corp. III
PFTAU|Perception Capital Corp. III
PFTAW|Perception Capital Corp. III
PFX|PhenixFIN Corporation
PFXNZ|PhenixFIN Corporation
PGC|Peapack
PGEN|Precigen, Inc.
PGHL|Primega Group Holdings Limited
PGJ|Invesco Golden Dragon China 
PGNY|Progyny, Inc.
PGY|Pagaya Technologies Ltd.
PGYWW|Pagaya Technologies Ltd.
PHAR|Pharming Group N.V.
PHAT|Phathom Pharmaceuticals, Inc.
PHIO|Phio Pharmaceuticals Corp.
PHO|Invesco Water Resources 
PHUN|Phunware, Inc.
PHVS|Pharvaris N.V.
PI|Impinj, Inc.
PID|Invesco International Dividend Achievers 
PIE|Invesco Dorsey Wright Emerging Markets Momentum 
PIII|P3 Health Partners Inc.
PIIIW|P3 Health Partners Inc.
PIK|Kidpik Corp.
PINC|Premier, Inc.
PIO|Invesco Global Water 
PIRS|Pieris Pharmaceuticals, Inc.
PITA|Heramba Electric plc
PITAW|Heramba Electric plc
PIZ|Invesco Dorsey Wright Developed Markets Momentum 
PKBK|Parke Bancorp, Inc.
PKOH|Park
PKW|Invesco BuyBack Achievers 
PLAB|Photronics, Inc.
PLAO|Patria Latin American Opportunity Acquisition Corp.
PLAY|Dave & Buster's Entertainment, Inc.
PLBC|Plumas Bancorp
PLBY|PLBY Group, Inc.
PLCE|Children's Place, Inc. (The)
PLL|Piedmont Lithium Inc.
PLMJ|Plum Acquisition Corp. III
PLMJU|Plum Acquisition Corp. III
PLMJW|Plum Acquisition Corp. III
PLMR|Palomar Holdings, Inc.
PLPC|Preformed Line Products Company
PLRX|Pliant Therapeutics, Inc.
PLRZ|Polyrizon Ltd.
PLSE|Pulse Biosciences, Inc
PLTK|Playtika Holding Corp.
PLUG|Plug Power, Inc.
PLUR|Pluri Inc.
PLUS|ePlus inc.
PLXS|Plexus Corp.
PLYA|Playa Hotels & Resorts N.V.
PMAX|Powell Max Limited
PMBS|PIMCO Mortgage
PMCB|PharmaCyte  Biotech, Inc.
PMD|Psychemedics Corporation
PMEC|Primech Holdings Ltd.
PMN|ProMIS Neurosciences Inc.
PMTS|CPI Card Group Inc.
PMVP|PMV Pharmaceuticals, Inc.
PNBK|Patriot National Bancorp Inc.
PNFP|Pinnacle Financial Partners, Inc.
PNFPP|Pinnacle Financial Partners, Inc.
PNQI|Invesco Nasdaq Internet 
PNRG|PrimeEnergy Resources Corporation
PNTG|The Pennant Group, Inc.
POAI|Predictive Oncology Inc.
POCI|Precision Optics Corporation, Inc.
PODC|PodcastOne, Inc.
PODD|Insulet Corporation
POET|POET Technologies Inc.
POLA|Polar Power, Inc.
POLE|Andretti Acquisition Corp. II
POLEU|Andretti Acquisition Corp. II
POLEW|Andretti Acquisition Corp. II
POOL|Pool Corporation
POWI|Power Integrations, Inc.
POWL|Powell Industries, Inc.
POWW|AMMO, Inc.
POWWP|AMMO, Inc.
PPBI|Pacific Premier Bancorp Inc
PPBT|Purple Biotech Ltd.
PPC|Pilgrim's Pride Corporation
PPH|VanEck Pharmaceutical 
PPI|AXS Astoria Real Assets 
PPIH|Perma
PPSI|Pioneer Power Solutions, Inc.
PPTA|Perpetua Resources Corp.
PPYA|Papaya Growth Opportunity Corp. I
PPYAU|Papaya Growth Opportunity Corp. I
PPYAW|Papaya Growth Opportunity Corp. I
PRAA|PRA Group, Inc.
PRAX|Praxis Precision Medicines, Inc.
PRCH|Porch Group, Inc.
PRCT|PROCEPT BioRobotics Corporation
PRDO|Perdoceo Education Corporation
PRE|Prenetics Global Limited
PRENW|Prenetics Global Limited
PRFX|PainReform Ltd.
PRFZ|Invesco FTSE RAFI US 1500 Small
PRGS|Progress Software Corporation
PRLD|Prelude Therapeutics Incorporated
PRLH|Pearl Holdings Acquisition Corp
PRLHU|Pearl Holdings Acquisition Corp
PRLHW|Pearl Holdings Acquisition Corp
PRME|Prime Medicine, Inc.
PRN|Invesco Dorsey Wright Industrials Momentum 
PROC|Procaps Group, S.A.
PROCW|Procaps Group, S.A.
PROF|Profound Medical Corp.
PROK|ProKidney Corp.
PROP|Prairie Operating Co.
PROV|Provident Financial Holdings, Inc.
PRPH|ProPhase Labs, Inc.
PRPL|Purple Innovation, Inc.
PRPO|Precipio, Inc.
PRQR|ProQR Therapeutics N.V.
PRSO|Peraso Inc.
PRTA|Prothena Corporation plc
PRTC|PureTech Health plc
PRTG|Portage Biotech Inc.
PRTH|Priority Technology Holdings, Inc.
PRTS|CarParts.com, Inc.
PRVA|Privia Health Group, Inc.
PRZO|ParaZero Technologies Ltd.
PSC|Principal U.S. Small
PSCC|Invesco S&P SmallCap Consumer Staples 
PSCD|Invesco S&P SmallCap Consumer Discretionary 
PSCE|Invesco S&P SmallCap Energy 
PSCF|Invesco S&P SmallCap Financials 
PSCH|Invesco S&P SmallCap Health Care 
PSCI|Invesco S&P SmallCap Industrials 
PSCM|Invesco S&P SmallCap Materials 
PSCT|Invesco S&P SmallCap Information Technology 
PSCU|Invesco S&P SmallCap Utilities & Communication Services 
PSEC|Prospect Capital Corporation
PSET|Principal Quality 
PSHG|Performance Shipping Inc.
PSIG|PS International Group Ltd.
PSL|Invesco Dorsey Wright Consumer Staples Momentum 
PSMT|PriceSmart, Inc.
PSNL|Personalis, Inc.
PSNY|Polestar Automotive Holding UK Limited
PSNYW|Polestar Automotive Holding UK Limited
PSTR|PeakShares Sector Rotation 
PSTV|PLUS THERAPEUTICS, Inc.
PSTX|Poseida Therapeutics, Inc.
PSWD|Xtrackers Cybersecurity Select Equity 
PT|Pintec Technology Holdings Limited
PTC|PTC Inc.
PTCT|PTC Therapeutics, Inc.
PTEC|Global X PropTech 
PTEN|Patterson
PTF|Invesco Dorsey Wright Technology Momentum 
PTGX|Protagonist Therapeutics, Inc.
PTH|Invesco Dorsey Wright Healthcare Momentum 
PTHL|Pheton Holdings Ltd
PTIR|GraniteShares  Long PLTR Daily 
PTIX|Protagenic Therapeutics, Inc.
PTIXW|Protagenic Therapeutics, Inc.
PTLE|PTL LTD
PTLO|Portillo's Inc.
PTMN|Portman Ridge Finance Corporation
PTNQ|Pacer Trendpilot 100 
PTON|Peloton Interactive, Inc.
PTPI|Petros Pharmaceuticals, Inc.
PTVE|Pactiv Evergreen Inc.
PUBM|PubMatic, Inc.
PUI|Invesco Dorsey Wright Utilities Momentum 
PULM|Pulmatrix, Inc.
PVBC|Provident Bancorp, Inc.
PWM|Prestige Wealth Inc.
PWOD|Penns Woods Bancorp, Inc.
PWP|Perella Weinberg Partners
PWUP|PowerUp Acquisition Corp.
PWUPU|PowerUp Acquisition Corp.
PWUPW|PowerUp Acquisition Corp.
PXI|Invesco Dorsey Wright Energy Momentum 
PXLW|Pixelworks, Inc.
PXS|Pyxis Tankers Inc.
PXSAW|Pyxis Tankers Inc.
PY|Principal Value 
PYCR|Paycor HCM, Inc.
PYPD|PolyPid Ltd.
PYPL|PayPal Holdings, Inc.
PYXS|Pyxis Oncology, Inc.
PYZ|Invesco Dorsey Wright Basic Materials Momentum 
PZZA|Papa John's International, Inc.
QABA|First Trust NASDAQ ABA Community Bank Index Fund
QAT|iShares MSCI Qatar 
QBUF|Innovator Nasdaq
QCLN|First Trust NASDAQ Clean Edge Green Energy Index Fund
QCLR|Global X NASDAQ 100 Collar 95
QCOM|QUALCOMM Incorporated
QCRH|QCR Holdings, Inc.
QDEL|QuidelOrtho Corporation
QETA|Quetta Acquisition Corporation
QETAR|Quetta Acquisition Corporation
QETAU|Quetta Acquisition Corporation
QFIN|Qifu Technology, Inc
QH|Quhuo Limited
QHDG|Innovator Hedged Nasdaq
QIPT|Quipt Home Medical Corp.
QLGN|Qualigen Therapeutics, Inc.
QLYS|Qualys, Inc.
QMCO|Quantum Corporation
QMID|WisdomTree U.S. MidCap Quality Growth Fund
QMMM|QMMM Holdings Limited
QMOM|Alpha Architect U.S. Quantitative Momentum 
QNCX|Quince Therapeutics, Inc.
QNRX|Quoin Pharmaceuticals, Ltd.
QNST|QuinStreet, Inc.
QNTM|Quantum Biopharma Ltd.
QNXT|iShares Nasdaq
QOWZ|Invesco Nasdaq Free Cash Flow Achievers 
QQA|Invesco QQQ Income Advantage 
QQEW|First Trust NASDAQ
QQJG|Invesco ESG NASDAQ Next Gen 100 
QQMG|Invesco ESG NASDAQ 100 
QQQ|Invesco QQQ Trust, Series 1
QQQA|ProShares Nasdaq
QQQG|Pacer Nasdaq 100 Top 50 Cash Cows Growth Leaders 
QQQI|NEOS Nasdaq 100 High Income 
QQQJ|Invesco NASDAQ Next Gen 100 
QQQM|Invesco NASDAQ 100 
QQQP|Tradr  Long Triple Q Quarterly 
QQQS|Invesco NASDAQ Future Gen 200 
QQQT|Defiance Nasdaq 100 Income Target 
QQQW|Tradr  Long Triple Q Weekly 
QQQX|Nuveen NASDAQ 100 Dynamic Overwrite Fund
QQQY|Defiance Nasdaq 100 Enhanced Options & 0DTE Income 
QQXT|First Trust NASDAQ
QRHC|Quest Resource Holding Corporation
QRMI|Global X NASDAQ 100 Risk Managed Income 
QRTEA|Qurate Retail, Inc.
QRTEB|Qurate Retail, Inc.
QRTEP|Qurate Retail, Inc.
QRVO|Qorvo, Inc.
QSG|QuantaSing Group Limited
QSI|Quantum
QSIAW|Quantum
QSIX|Pacer Metaurus Nasdaq 100 Dividend Multiplier 600 
QSML|WisdomTree U.S. SmallCap Quality Growth Fund
QTEC|First Trust NASDAQ
QTI|QT Imaging Holdings, Inc.
QTOP|iShares Nasdaq Top 30 Stocks 
QTR|Global X NASDAQ 100 Tail Risk 
QTRX|Quanterix Corporation
QTTB|Q32 Bio Inc.
QTUM|Defiance Quantum 
QUBT|Quantum Computing Inc.
QUIK|QuickLogic Corporation
QURE|uniQure N.V.
QVAL|Alpha Architect U.S. Quantitative Value 
QXO|QXO, Inc.
QXQ|SGI Enhanced Nasdaq
QYLD|Global X NASDAQ 100 Covered Call 
QYLE|Global X Nasdaq 100 ESG Covered Call 
QYLG|Global X Nasdaq 100 Covered Call & Growth 
RAIL|Freightcar America, Inc.
RAND|Rand Capital Corporation
RANI|Rani Therapeutics Holdings, Inc.
RAPP|Rapport Therapeutics, Inc.
RAPT|RAPT Therapeutics, Inc.
RARE|Ultragenyx Pharmaceutical Inc.
RAVE|Rave Restaurant Group, Inc.
RAY|Raytech Holding Limited
RAYA|Erayak Power Solution Group Inc.
RAYS|Global X Solar 
RBB|RBB Bancorp
RBBN|Ribbon Communications Inc.
RBCAA|Republic Bancorp, Inc.
RBKB|Rhinebeck Bancorp, Inc.
RCAT|Red Cat Holdings, Inc.
RCEL|Avita Medical, Inc.
RCKT|Rocket Pharmaceuticals, Inc.
RCKTW|Rocket Pharmaceuticals, Inc.
RCKY|Rocky Brands, Inc.
RCMT|RCM Technologies, Inc.
RCON|Recon Technology, Ltd.
RDACU|Rising Dragon Acquisition Corp.
RDCM|Radcom Ltd.
RDFN|Redfin Corporation
RDHL|Redhill Biopharma Ltd.
RDI|Reading International Inc
RDIB|Reading International Inc
RDNT|RadNet, Inc.
RDUS|Radius Recycling, Inc.
RDVT|Red Violet, Inc.
RDVY|First Trust Rising Dividend Achievers 
RDWR|Radware Ltd.
RDZN|Roadzen, Inc.
RDZNW|Roadzen, Inc.
REAI|Intelligent Real Estate 
REAL|The RealReal, Inc.
REAX|The Real Brokerage, Inc.
REBN|Reborn Coffee, Inc.
RECT|Rectitude Holdings Ltd
REE|REE Automotive Ltd.
REFI|Chicago Atlantic Real Estate Finance, Inc.
REFR|Research Frontiers Incorporated
REG|Regency Centers Corporation
REGCO|Regency Centers Corporation
REGCP|Regency Centers Corporation
REGN|Regeneron Pharmaceuticals, Inc.
REIT|ALPS Active REIT 
REKR|Rekor Systems, Inc.
RELI|Reliance Global Group, Inc.
RELIW|Reliance Global Group, Inc.
RELL|Richardson Electronics, Ltd.
RELY|Remitly Global, Inc.
RENB|Renovaro Inc.
RENE|Cartesian Growth Corporation II
RENEU|Cartesian Growth Corporation II
RENEW|Cartesian Growth Corporation II
RENT|Rent the Runway, Inc.
REPL|Replimune Group, Inc.
RETO|ReTo Eco
REVB|Revelation Biosciences, Inc.
REVBW|Revelation Biosciences, Inc.
REYN|Reynolds Consumer Products Inc.
RFAC|RF Acquisition Corp.
RFACR|RF Acquisition Corp.
RFACU|RF Acquisition Corp.
RFACW|RF Acquisition Corp.
RFAI|RF Acquisition Corp II
RFAIR|RF Acquisition Corp II
RFAIU|RF Acquisition Corp II
RFDI|First Trust RiverFront Dynamic Developed International 
RFEM|First Trust RiverFront Dynamic Emerging Markets 
RFEU|First Trust RiverFront Dynamic Europe 
RFIL|RF Industries, Ltd.
RGC|Regencell Bioscience Holdings Limited
RGCO|RGC Resources Inc.
RGEN|Repligen Corporation
RGF|The Real Good Food Company, Inc.
RGLD|Royal Gold, Inc.
RGLS|Regulus Therapeutics Inc.
RGNX|REGENXBIO Inc.
RGP|Resources Connection, Inc.
RGS|Regis Corporation
RGTI|Rigetti Computing, Inc.
RGTIW|Rigetti Computing, Inc.
RICK|RCI Hospitality Holdings, Inc.
RIGL|Rigel Pharmaceuticals, Inc.
RILY|B. Riley Financial, Inc.
RILYG|B. Riley Financial, Inc.
RILYK|B. Riley Financial, Inc.
RILYL|B. Riley Financial, Inc.
RILYM|B. Riley Financial, Inc.
RILYN|B. Riley Financial, Inc.
RILYP|B. Riley Financial, Inc.
RILYT|B. Riley Financial, Inc.
RILYZ|B. Riley Financial, Inc.
RIME|Algorhythm Holdings, Inc.
RING|iShares MSCI Global Gold Miners 
RIOT|Riot Platforms, Inc.
RITR|Reitar Logtech Holdings Limited
RIVN|Rivian Automotive, Inc.
RKDA|Arcadia Biosciences, Inc.
RKLB|Rocket Lab USA, Inc.
RLAY|Relay Therapeutics, Inc.
RLMD|Relmada Therapeutics, Inc.
RLYB|Rallybio Corporation
RMBI|Richmond Mutual Bancorporation, Inc.
RMBL|RumbleOn, Inc.
RMBS|Rambus, Inc.
RMCF|Rocky Mountain Chocolate Factory, Inc.
RMCO|Royalty Management Holding Corporation
RMCOW|Royalty Management Holding Corporation
RMNI|Rimini Street, Inc.
RMR|The RMR Group Inc.
RMSG|Real Messenger Corporation
RMSGW|Real Messenger Corporation
RMTI|Rockwell Medical, Inc.
RNA|Avidity Biosciences, Inc.
RNAC|Cartesian Therapeutics, Inc.
RNAZ|TransCode Therapeutics, Inc.
RNEM|Emerging Markets Equity Select 
RNEW|VanEck Green Infrastructure 
RNRG|Global X Renewable Energy Producers 
RNSC|Small Cap US Equity Select 
RNW|ReNew Energy Global plc
RNWWW|ReNew Energy Global plc
RNXT|RenovoRx, Inc.
ROAD|Construction Partners, Inc.
ROBT|First Trust Nasdaq Artificial Intelligence and Robotics 
ROCK|Gibraltar Industries, Inc.
ROCL|Roth CH Acquisition V Co.
ROCLU|Roth CH Acquisition V Co.
ROCLW|Roth CH Acquisition V Co.
ROE|Astoria US Equal Weight Quality Kings 
ROIC|Retail Opportunity Investments Corp.
ROIV|Roivant Sciences Ltd.
ROKU|Roku, Inc.
ROMA|Roma Green Finance Limited
ROOT|Root, Inc.
ROP|Roper Technologies, Inc.
ROST|Ross Stores, Inc.
RPAY|Repay Holdings Corporation
RPD|Rapid7, Inc.
RPID|Rapid Micro Biosystems, Inc.
RPRX|Royalty Pharma plc
RPTX|Repare Therapeutics Inc.
RR|Richtech Robotics Inc.
RRBI|Red River Bancshares, Inc.
RRGB|Red Robin Gourmet Burgers, Inc.
RRR|Red Rock Resorts, Inc.
RSLS|ReShape Lifesciences, Inc.
RSSS|Research Solutions, Inc
RSVR|Reservoir Media, Inc..
RSVRW|Reservoir Media, Inc..
RTC|Baijiayun Group Ltd
RTH|VanEck Retail 
RUM|Rumble Inc.
RUMBW|Rumble Inc.
RUN|Sunrun Inc.
RUNN|Running Oak Efficient Growth 
RUSHA|Rush Enterprises, Inc.
RUSHB|Rush Enterprises, Inc.
RVMD|Revolution Medicines, Inc.
RVMDW|Revolution Medicines, Inc.
RVNC|Revance Therapeutics, Inc.
RVPH|Reviva Pharmaceuticals Holdings, Inc.
RVPHW|Reviva Pharmaceuticals Holdings, Inc.
RVSB|Riverview Bancorp Inc
RVSN|Rail Vision Ltd.
RVSNW|Rail Vision Ltd.
RVYL|Ryvyl Inc.
RWAY|Runway Growth Finance Corp.
RWAYL|Runway Growth Finance Corp.
RWAYZ|Runway Growth Finance Corp.
RXRX|Recursion Pharmaceuticals, Inc.
RXST|RxSight, Inc.
RXT|Rackspace Technology, Inc.
RYAAY|Ryanair Holdings plc
RYTM|Rhythm Pharmaceuticals, Inc.
RZLT|Rezolute, Inc.
RZLV|Rezolve AI Limited
RZLVW|Rezolve AI Limited
SABR|Sabre Corporation
SABS|SAB Biotherapeutics, Inc.
SABSW|SAB Biotherapeutics, Inc.
SAFT|Safety Insurance Group, Inc.
SAG|SAG Holdings Limited
SAGE|Sage Therapeutics, Inc.
SAIA|Saia, Inc.
SAIC|Science Applications International Corporation
SAIH|SAIHEAT Limited
SAIHW|SAIHEAT Limited
SAMG|Silvercrest Asset Management Group Inc.
SANA|Sana Biotechnology, Inc.
SANG|Sangoma Technologies Corporation
SANM|Sanmina Corporation
SANW|S&W Seed Company
SARK|Tradr  Short Innovation Daily 
SASR|Sandy Spring Bancorp, Inc.
SATL|Satellogic Inc.
SATLW|Satellogic Inc.
SATS|EchoStar Corporation
SAVA|Cassava Sciences, Inc.
SBAC|SBA Communications Corporation
SBC|SBC Medical Group Holdings Incorporated
SBCF|Seacoast Banking Corporation of Florida
SBCWW|SBC Medical Group Holdings Incorporated
SBET|SharpLink Gaming, Inc.
SBFG|SB Financial Group, Inc.
SBFM|Sunshine Biopharma Inc.
SBFMW|Sunshine Biopharma Inc.
SBGI|Sinclair, Inc.
SBLK|Star Bulk Carriers Corp.
SBRA|Sabra Health Care REIT, Inc.
SBT|Sterling Bancorp, Inc.
SBUX|Starbucks Corporation
SCDS|JPMorgan Fundamental Data Science Small Core 
SCHL|Scholastic Corporation
SCKT|Socket Mobile, Inc.
SCLX|Scilex Holding Company
SCLXW|Scilex Holding Company
SCNI|Scinai Immunotherapeutics Ltd.
SCNX|Scienture Holdings, Inc.
SCOR|comScore, Inc.
SCPH|scPharmaceuticals Inc.
SCSC|ScanSource, Inc.
SCVL|Shoe Carnival, Inc.
SCWO|374Water Inc.
SCWX|SecureWorks Corp.
SCYX|SCYNEXIS, Inc.
SCZ|iShares MSCI EAFE Small
SDA|SunCar Technology Group Inc.
SDAWW|SunCar Technology Group Inc.
SDG|iShares MSCI Global Sustainable Development Goals 
SDGR|Schrodinger, Inc.
SDIG|Stronghold Digital Mining, Inc.
SDOT|Sadot Group Inc.
SDSI|American Century Short Duration Strategic Income 
SDST|Stardust Power Inc.
SDSTW|Stardust Power Inc.
SEAT|Vivid Seats Inc.
SEATW|Vivid Seats Inc.
SEDG|SolarEdge Technologies, Inc.
SEED|Origin Agritech Limited
SEEM|SEI Select Emerging Markets Equity 
SEER|Seer, Inc.
SEIC|SEI Investments Company
SEIE|SEI Select International Equity 
SEIS|SEI Select Small Cap 
SELF|Global Self Storage, Inc.
SELX|Semilux International Ltd.
SENEA|Seneca Foods Corp.
SENEB|Seneca Foods Corp.
SEPN|Septerna, Inc.
SERA|Sera Prognostics, Inc.
SERV|Serve Robotics Inc.
SETM|Sprott Critical Materials 
SEVN|Seven Hills Realty Trust
SEZL|Sezzle Inc.
SFBC|Sound Financial Bancorp, Inc.
SFHG|Samfine Creation Holdings Group Limited
SFIX|Stitch Fix, Inc.
SFLO|VictoryShares Small Cap Free Cash Flow 
SFM|Sprouts Farmers Market, Inc.
SFNC|Simmons First National Corporation
SFST|Southern First Bancshares, Inc.
SFWL|Shengfeng Development Limited
SGA|Saga Communications, Inc.
SGBX|Safe & Green Holdings Corp.
SGC|Superior Group of Companies, Inc.
SGD|Safe and Green Development Corporation
SGHT|Sight Sciences, Inc.
SGLY|Singularity Future Technology Ltd.
SGMA|SigmaTron International, Inc.
SGML|Sigma Lithium Corporation
SGMO|Sangamo Therapeutics, Inc.
SGMT|Sagimet Biosciences Inc.
SGRP|SPAR Group, Inc.
SGRY|Surgery Partners, Inc.
SHBI|Shore Bancshares, Inc.
SHC|Sotera Health Company
SHEN|Shenandoah Telecommunications Co
SHFS|SHF Holdings, Inc.
SHFSW|SHF Holdings, Inc.
SHIM|Shimmick Corporation
SHIP|Seanergy Maritime Holdings Corp.
SHLS|Shoals Technologies Group, Inc.
SHLT|SHL Telemedicine Ltd
SHMD|SCHMID Group N.V.
SHMDW|SCHMID Group N.V.
SHOO|Steven Madden, Ltd.
SHOT|Safety Shot, Inc.
SHOTW|Safety Shot, Inc.
SHPH|Shuttle Pharmaceuticals Holdings, Inc.
SHYF|The Shyft Group, Inc.
SIBN|SI
SIDU|Sidus Space, Inc.
SIEB|Siebert Financial Corp.
SIFY|Sify Technologies Limited
SIGA|SIGA Technologies Inc.
SIGI|Selective Insurance Group, Inc.
SIGIP|Selective Insurance Group, Inc.
SILC|Silicom Ltd
SILO|Silo Pharma, Inc.
SIMA|SIM Acquisition Corp. I
SIMAU|SIM Acquisition Corp. I
SIMAW|SIM Acquisition Corp. I
SIMO|Silicon Motion Technology Corporation
SINT|SiNtx Technologies, Inc.
SIRI|SiriusXM Holdings Inc.
SISI|Shineco, Inc.
SITM|SiTime Corporation
SIXG|Defiance Connective Technologies 
SJ|Scienjoy Holding Corporation
SJCP|SanJac Alpha Core Plus Bond 
SJLD|SanJac Alpha Low Duration 
SJW|SJW Group
SKGR|SK Growth Opportunities Corporation
SKGRU|SK Growth Opportunities Corporation
SKGRW|SK Growth Opportunities Corporation
SKIN|The Beauty Health Company
SKK|SKK Holdings Limited
SKOR|FlexShares Credit
SKRE|Tuttle Capital Daily  Inverse Regional Banks 
SKWD|Skyward Specialty Insurance Group, Inc.
SKYE|Skye Bioscience, Inc.
SKYQ|Sky Quarry Inc.
SKYT|SkyWater Technology, Inc.
SKYU|ProShares Ultra Cloud Computing
SKYW|SkyWest, Inc.
SKYX|SKYX Platforms Corp.
SKYY|First Trust Cloud Computing 
SLAB|Silicon Laboratories, Inc.
SLDB|Solid Biosciences Inc.
SLDP|Solid Power, Inc.
SLDPW|Solid Power, Inc.
SLE|Super League Enterprise, Inc.
SLGL|Sol
SLM|SLM Corporation
SLMBP|SLM Corporation
SLN|Silence Therapeutics Plc
SLNG|Stabilis Solutions, Inc.
SLNH|Soluna Holdings, Inc.
SLNHP|Soluna Holdings, Inc.
SLNO|Soleno Therapeutics, Inc.
SLP|Simulations Plus, Inc.
SLQD|iShares 0
SLRC|SLR Investment Corp.
SLRN|ACELYRIN, INC.
SLRX|Salarius Pharmaceuticals, Inc.
SLS|SELLAS Life Sciences Group, Inc.
SLVO|ETRACS Silver Shares Covered Call ETNs due April 21, 2033
SLXN|Silexion Therapeutics Corp
SLXNW|Silexion Therapeutics Corp
SMBC|Southern Missouri Bancorp, Inc.
SMCF|Themes US Small Cap Cash Flow Champions 
SMCI|Super Micro Computer, Inc.
SMCO|Hilton Small
SMCP|AlphaMark Actively Managed Small Cap 
SMCX|Defiance Daily Target  Long SMCI 
SMH|VanEck Semiconductor 
SMHX|VanEck Fabless Semiconductor 
SMID|Smith
SMLR|Semler Scientific, Inc.
SMMT|Summit Therapeutics Inc.
SMPL|The Simply Good Foods Company
SMRI|Bushido Capital US Equity 
SMSI|Smith Micro Software, Inc.
SMST|Defiance Daily Target  Short MSTR 
SMTC|Semtech Corporation
SMTI|Sanara MedTech Inc.
SMTK|SmartKem, Inc.
SMX|SMX (Security Matters) Public Limited Company
SMXT|Solarmax Technology Inc.
SMXWW|SMX (Security Matters) Public Limited Company
SNAL|Snail, Inc.
SNAX|Stryve Foods, Inc.
SNAXW|Stryve Foods, Inc.
SNBR|Sleep Number Corporation
SNCR|Synchronoss Technologies, Inc.
SNCRL|Synchronoss Technologies, Inc.
SNCY|Sun Country Airlines Holdings, Inc.
SND|Smart Sand, Inc.
SNDL|SNDL Inc.
SNDX|Syndax Pharmaceuticals, Inc.
SNES|SenesTech, Inc.
SNEX|StoneX Group Inc.
SNFCA|Security National Financial Corporation
SNGX|Soligenix, Inc.
SNOA|Sonoma Pharmaceuticals, Inc.
SNPS|Synopsys, Inc.
SNPX|Synaptogenix, Inc.
SNRE|Sunrise Communications AG
SNSE|Sensei Biotherapeutics, Inc.
SNSR|Global X Internet of Things 
SNT|Senstar Technologies Corporation
SNTG|Sentage Holdings Inc.
SNTI|Senti Biosciences, Inc.
SNY|Sanofi
SNYR|Synergy CHC Corp.
SOBR|SOBR Safe, Inc.
SOCL|Global X Social Media 
SOFI|SoFi Technologies, Inc.
SOGP|Sound Group Inc.
SOHO|Sotherly Hotels Inc.
SOHOB|Sotherly Hotels Inc.
SOHON|Sotherly Hotels Inc.
SOHOO|Sotherly Hotels Inc.
SOHU|Sohu.com Limited
SOND|Sonder Holdings Inc.
SONDW|Sonder Holdings Inc.
SONM|Sonim Technologies, Inc.
SONN|Sonnet BioTherapeutics Holdings, Inc.
SONO|Sonos, Inc.
SOPA|Society Pass Incorporated
SOPH|SOPHiA GENETICS SA
SOTK|Sono
SOUN|SoundHound AI, Inc.
SOUNW|SoundHound AI, Inc.
SOWG|Sow Good Inc.
SOXM|Tradr  Long SOXX Monthly 
SOXQ|Invesco PHLX Semiconductor 
SOXW|Tradr  Long SOXX Weekly 
SOXX|iShares Semiconductor 
SPAI|Safe Pro Group Inc.
SPAM|Themes Cybersecurity 
SPAQ|Horizon Kinetics SPAC Active 
SPBC|Simplify U.S. Equity PLUS GBTC 
SPC|CrossingBridge Pre
SPCB|SuperCom, Ltd.
SPCX|SPAC and New Issue 
SPFI|South Plains Financial, Inc.
SPGC|Sacks Parente Golf, Inc.
SPHL|Springview Holdings Ltd
SPI|SPI Energy Co., Ltd.
SPKL|Spark I Acquisition Corp.
SPKLU|Spark I Acquisition Corp.
SPKLW|Spark I Acquisition Corp.
SPNS|Sapiens International Corporation N.V.
SPOK|Spok Holdings, Inc.
SPPL|SIMPPLE LTD.
SPRB|Spruce Biosciences, Inc.
SPRC|SciSparc Ltd.
SPRO|Spero Therapeutics, Inc.
SPRX|Spear Alpha 
SPRY|ARS Pharmaceuticals, Inc.
SPSC|SPS Commerce, Inc.
SPT|Sprout Social, Inc
SPTN|SpartanNash Company
SPWH|Sportsman's Warehouse Holdings, Inc.
SPYB|Tradr  Long SPY Weekly 
SPYM|Tradr  Long SPY Monthly 
SPYQ|Tradr  Long SPY Quarterly 
SQFT|Presidio Property Trust, Inc.
SQFTP|Presidio Property Trust, Inc.
SQFTW|Presidio Property Trust, Inc.
SQLV|Royce Quant Small
SQQQ|ProShares UltraPro Short QQQ
SRAD|Sportradar Group AG
SRBK|SR Bancorp, Inc.
SRCE|1st Source Corporation
SRDX|Surmodics, Inc.
SRET|Global X SuperDividend REIT 
SRM|SRM Entertainment, Inc.
SRPT|Sarepta Therapeutics, Inc.
SRRK|Scholar Rock Holding Corporation
SRTS|Sensus Healthcare, Inc.
SRZN|Surrozen, Inc.
SRZNW|Surrozen, Inc.
SSBI|Summit State Bank
SSBK|Southern States Bancshares, Inc.
SSKN|Strata Skin Sciences, Inc.
SSNC|SS&C Technologies Holdings, Inc.
SSP|E.W. Scripps Company (The)
SSRM|SSR Mining Inc.
SSSS|SuRo Capital Corp.
SSSSL|SuRo Capital Corp.
SSTI|SoundThinking, Inc.
SSYS|Stratasys, Ltd.
STAA|STAAR Surgical Company
STAF|Staffing 360 Solutions, Inc.
STBA|S&T Bancorp, Inc.
STBX|Starbox Group Holdings Ltd.
STCN|Steel Connect, Inc.
STEC|Santech Holdings Limited
STEP|StepStone Group Inc.
STFS|Star Fashion Culture Holdings Limited
STGW|Stagwell Inc.
STHO|Star Holdings
STI|Solidion Technology, Inc.
STIM|Neuronetics, Inc.
STKH|Steakholder Foods Ltd.
STKL|SunOpta, Inc.
STKS|The ONE Group Hospitality, Inc.
STLD|Steel Dynamics, Inc.
STNE|StoneCo Ltd.
STOK|Stoke Therapeutics, Inc.
STRA|Strategic Education, Inc.
STRL|Sterling Infrastructure, Inc.
STRM|Streamline Health Solutions, Inc.
STRO|Sutro Biopharma, Inc.
STRR|Star Equity Holdings, Inc.
STRRP|Star Equity Holdings, Inc.
STRS|Stratus Properties Inc.
STRT|STRATTEC SECURITY CORPORATION
STSB|Stance Sustainable Beta 
STSS|Sharps Technology Inc.
STSSW|Sharps Technology Inc.
STTK|Shattuck Labs, Inc.
STX|Seagate Technology Holdings PLC
SUGP|SU Group Holdings Limited
SUNE|SUNation Energy, Inc.
SUNS|Sunrise Realty Trust, Inc.
SUPN|Supernus Pharmaceuticals, Inc.
SURG|SurgePays, Inc.
SUSB|iShares ESG Aware 1
SUSC|iShares ESG Aware USD Corporate Bond 
SUSL|iShares ESG MSCI USA Leaders 
SUUN|SolarBank Corporation
SVA|Sinovac Biotech, Ltd.
SVC|Service Properties Trust
SVCO|Silvaco Group, Inc.
SVII|Spring Valley Acquisition Corp. II
SVIIR|Spring Valley Acquisition Corp. II
SVIIU|Spring Valley Acquisition Corp. II
SVIIW|Spring Valley Acquisition Corp. II
SVMH|SRIVARU Holding Limited
SVMHW|SRIVARU Holding Limited
SVRA|Savara, Inc.
SVRE|SaverOne 2014 Ltd.
SVREW|SaverOne 2014 Ltd.
SWAG|Stran & Company, Inc.
SWAGW|Stran & Company, Inc.
SWBI|Smith & Wesson Brands, Inc.
SWIM|Latham Group, Inc.
SWIN|Solowin Holdings
SWKH|SWK Holdings Corporation
SWKHL|SWK Holdings Corporation
SWKS|Skyworks Solutions, Inc.
SWP|SWP Growth & Income 
SWTX|SpringWorks Therapeutics, Inc.
SWVL|Swvl Holdings Corp
SWVLW|Swvl Holdings Corp
SXTC|China SXT Pharmaceuticals, Inc.
SXTP|60 Degrees Pharmaceuticals, Inc.
SXTPW|60 Degrees Pharmaceuticals, Inc.
SY|So
SYBT|Stock Yards Bancorp, Inc.
SYBX|Synlogic, Inc.
SYM|Symbotic Inc.
SYNA|Synaptics Incorporated
SYPR|Sypris Solutions, Inc.
SYRA|Syra Health Corp.
SYRE|Spyre Therapeutics, Inc.
SYRS|Syros Pharmaceuticals, Inc.
SYT|SYLA Technologies Co., Ltd.
SYTA|Siyata Mobile, Inc.
SYTAW|Siyata Mobile, Inc.
TACT|TransAct Technologies Incorporated
TAIT|Taitron Components Incorporated
TALK|Talkspace, Inc.
TALKW|Talkspace, Inc.
TANH|Tantech Holdings Ltd.
TAOP|Taoping Inc.
TARA|Protara Therapeutics, Inc.
TARK|Tradr  Long Innovation 
TARS|Tarsus Pharmaceuticals, Inc.
TASK|TaskUs, Inc.
TATT|TAT Technologies Ltd.
TAXE|Intermediate Municipal Income 
TAYD|Taylor Devices, Inc.
TBBK|The Bancorp, Inc.
TBIL|US Treasury 3 Month Bill 
TBLA|Taboola.com Ltd.
TBLAW|Taboola.com Ltd.
TBLD|Thornburg Income Builder Opportunities Trust
TBMC|Trailblazer Merger Corporation I
TBMCR|Trailblazer Merger Corporation I
TBNK|Territorial Bancorp Inc.
TBPH|Theravance Biopharma, Inc.
TBRG|TruBridge, Inc.
TC|TuanChe Limited
TCBI|Texas Capital Bancshares, Inc.
TCBIO|Texas Capital Bancshares, Inc.
TCBK|TriCo Bancshares
TCBP|TC BioPharm (Holdings) plc
TCBPW|TC BioPharm (Holdings) plc
TCBS|Texas Community Bancshares, Inc.
TCBX|Third Coast Bancshares, Inc.
TCHI|iShares MSCI China Multisector Tech 
TCMD|Tactile Systems Technology, Inc.
TCOM|Trip.com Group Limited
TCPC|BlackRock TCP Capital Corp.
TCRT|Alaunos Therapeutics, Inc.
TCRX|TScan Therapeutics, Inc.
TCTM|TCTM Kids IT Education Inc.
TCX|Tucows Inc.
TDI|Touchstone Dynamic International 
TDSB|Cabana Target Beta 
TDSC|Cabana Target Drawdown 10 
TDTH|Trident Digital Tech Holdings Ltd
TDUP|ThredUp Inc.
TEAM|Atlassian Corporation
TECH|Bio
TECTP|Tectonic Financial, Inc.
TECX|Tectonic Therapeutic, Inc.
TEKX|SPDR Galaxy Transformative Tech Accelerators 
TELA|TELA Bio, Inc.
TELO|Telomir Pharmaceuticals, Inc.
TEM|Tempus AI, Inc.
TENB|Tenable Holdings, Inc.
TENX|Tenax Therapeutics, Inc.
TER|Teradyne, Inc.
TERN|Terns Pharmaceuticals, Inc.
TETE|Technology & Telecommunication Acquisition Corporation
TETEU|Technology & Telecommunication Acquisition Corporation
TETEW|Technology & Telecommunication Acquisition Corporation
TFFP|TFF Pharmaceuticals, Inc.
TFIN|Triumph Financial, Inc.
TFINP|Triumph Financial, Inc.
TFSL|TFS Financial Corporation
TGAA|Target Global Acquisition I Corp.
TGAAU|Target Global Acquisition I Corp.
TGAAW|Target Global Acquisition I Corp.
TGL|Treasure Global Inc.
TGTX|TG Therapeutics, Inc.
TH|Target Hospitality Corp.
THAR|Tharimmune, Inc.
THCH|TH International Limited
THCP|Thunder Bridge Capital Partners IV, Inc.
THCPU|Thunder Bridge Capital Partners IV, Inc.
THCPW|Thunder Bridge Capital Partners IV, Inc.
THFF|First Financial Corporation Indiana
THRD|Third Harmonic Bio, Inc.
THRM|Gentherm Inc
THRY|Thryv Holdings, Inc.
THTX|Theratechnologies Inc.
TIGO|Millicom International Cellular S.A.
TIGR|UP Fintech Holding Limited
TIL|Instil Bio, Inc.
TILE|Interface, Inc.
TIPT|Tiptree Inc.
TIRX|TIAN RUIXIANG Holdings Ltd
TITN|Titan Machinery Inc.
TIVC|Tivic Health Systems, Inc.
TKLF|Tokyo Lifestyle Co., Ltd.
TKNO|Alpha Teknova, Inc.
TLF|Tandy Leather Factory, Inc.
TLGY|TLGY Acquisition Corporation
TLGYU|TLGY Acquisition Corporation
TLGYW|TLGY Acquisition Corporation
TLN|Talen Energy Corporation
TLPH|Talphera, Inc.
TLRY|Tilray Brands, Inc.
TLS|Telos Corporation
TLSA|Tiziana Life Sciences Ltd
TLSI|TriSalus Life Sciences, Inc.
TLSIW|TriSalus Life Sciences, Inc.
TLTM|Tradr  Long TLT Monthly 
TLTQ|Tradr  Long TLT Quarterly 
TLX|Telix Pharmaceuticals Limited
TMC|TMC the metals company Inc.
TMCI|Treace Medical Concepts, Inc.
TMCWW|TMC the metals company Inc.
TMDX|TransMedics Group, Inc.
TMET|iShares Transition
TMUS|T
TNDM|Tandem Diabetes Care, Inc.
TNFA|TNF Pharmaceuticals, Inc.
TNGX|Tango Therapeutics, Inc.
TNON|Tenon Medical, Inc.
TNONW|Tenon Medical, Inc.
TNXP|Tonix Pharmaceuticals Holding Corp.
TNYA|Tenaya Therapeutics, Inc.
TOI|The Oncology Institute, Inc.
TOIIW|The Oncology Institute, Inc.
TOMZ|TOMI Environmental Solutions, Inc.
TOP|TOP Financial Group Limited
TORO|Toro Corp.
TOUR|Tuniu Corporation
TOWN|Towne Bank
TOYO|TOYO Co., Ltd
TPCS|TechPrecision Corporation
TPG|TPG Inc.
TPGXL|TPG Inc.
TPIC|TPI Composites, Inc.
TPST|Tempest Therapeutics, Inc.
TQQQ|ProShares UltraPro QQQ
TRAW|Traws Pharma, Inc.
TRDA|Entrada Therapeutics, Inc.
TREE|LendingTree, Inc.
TRIB|Trinity Biotech plc
TRIN|Trinity Capital Inc.
TRINI|Trinity Capital Inc.
TRINL|Trinity Capital Inc.
TRINZ|Trinity Capital Inc.
TRIP|TripAdvisor, Inc.
TRMB|Trimble Inc.
TRMD|TORM plc
TRMK|Trustmark Corporation
TRML|Tourmaline Bio, Inc.
TRNR|Interactive Strength Inc.
TRNS|Transcat, Inc.
TROO|TROOPS, Inc.
TROW|T. Rowe Price Group, Inc.
TRS|TriMas Corporation
TRSG|Tungray Technologies Inc
TRST|TrustCo Bank Corp NY
TRUE|TrueCar, Inc.
TRUG|TruGolf Holdings, Inc.
TRUP|Trupanion, Inc.
TRVG|trivago N.V.
TRVI|Trevi Therapeutics, Inc.
TSAT|Telesat Corporation
TSBK|Timberland Bancorp, Inc.
TSBX|Turnstone Biologics Corp.
TSCO|Tractor Supply Company
TSDD|GraniteShares  Short TSLA Daily 
TSEM|Tower Semiconductor Ltd.
TSHA|Taysha Gene Therapies, Inc.
TSL|GraniteShares  Long TSLA Daily 
TSLA|Tesla, Inc.
TSLQ|Tradr  Short TSLA Daily 
TSLR|GraniteShares  Long TSLA Daily 
TSLT|T
TSLW|Tradr  Long TSLA Weekly 
TSLZ|T
TSMU|GraniteShares  Long TSM Daily 
TSPY|TappAlpha SPY Growth & Daily Income 
TSSI|TSS, Inc.
TSVT|2seventy bio, Inc.
TTD|The Trade Desk, Inc.
TTEC|TTEC Holdings, Inc.
TTEK|Tetra Tech, Inc.
TTEQ|T. Rowe Price Technology 
TTGT|TechTarget, Inc.
TTMI|TTM Technologies, Inc.
TTNP|Titan Pharmaceuticals, Inc.
TTOO|T2 Biosystems, Inc.
TTSH|Tile Shop Holdings, Inc.
TTWO|Take
TUG|STF Tactical Growth 
TUGN|STF Tactical Growth & Income 
TUR|iShares MSCI Turkey 
TURB|Turbo Energy, S.A.
TURN|180 Degree Capital Corp.
TUSK|Mammoth Energy Services, Inc.
TVGN|Tevogen Bio Holdings Inc.
TVGNW|Tevogen Bio Holdings Inc.
TVTX|Travere Therapeutics, Inc.
TW|Tradeweb Markets Inc.
TWFG|TWFG, Inc.
TWG|Top Wealth Group Holding Limited
TWIN|Twin Disc, Incorporated
TWST|Twist Bioscience Corporation
TXG|10x Genomics, Inc.
TXMD|TherapeuticsMD, Inc.
TXN|Texas Instruments Incorporated
TXRH|Texas Roadhouse, Inc.
TYGO|Tigo Energy, Inc.
TYRA|Tyra Biosciences, Inc.
TZOO|Travelzoo
TZUP|Thumzup Media Corporation
UAE|iShares MSCI UAE 
UAL|United Airlines Holdings, Inc.
UBCP|United Bancorp, Inc.
UBSI|United Bankshares, Inc.
UBX|Unity Biotechnology, Inc.
UBXG|U-BX Technology Ltd.
UCAR|U Power Limited
UCL|uCloudlink Group Inc.
UCRD|VictoryShares Corporate Bond 
UCTT|Ultra Clean Holdings, Inc.
UCYB|ProShares Ultra Nasdaq Cybersecurity
UDMY|Udemy, Inc.
UEIC|Universal Electronics Inc.
UEVM|VictoryShares Emerging Markets Value Momentum 
UFCS|United Fire Group, Inc
UFIV|US Treasury 5 Year Note 
UFO|Procure Space 
UFPI|UFP Industries, Inc.
UFPT|UFP Technologies, Inc.
UG|United-Guardian, Inc.
UGRO|urban-gro, Inc.
UHG|United Homes Group, Inc
UHGWW|United Homes Group, Inc
UITB|VictoryShares Core Intermediate Bond 
UIVM|VictoryShares International Value Momentum 
UK|Ucommune International Ltd
UKOMW|Ucommune International Ltd
ULBI|Ultralife Corporation
ULCC|Frontier Group Holdings, Inc.
ULH|Universal Logistics Holdings, Inc.
ULTA|Ulta Beauty, Inc.
ULVM|VictoryShares US Value Momentum 
ULY|Urgent.ly Inc.
UMBF|UMB Financial Corporation
UMMA|Wahed Dow Jones Islamic World 
UNB|Union Bankshares, Inc.
UNCY|Unicycive Therapeutics, Inc.
UNIT|Uniti Group Inc.
UNTY|Unity Bancorp, Inc.
UONE|Urban One, Inc.
UONEK|Urban One, Inc.
UPB|Upstream Bio, Inc.
UPBD|Upbound Group, Inc.
UPC|Universe Pharmaceuticals Inc
UPGR|Xtrackers US Green Infrastructure Select Equity 
UPLD|Upland Software, Inc.
UPST|Upstart Holdings, Inc.
UPWK|Upwork Inc.
UPXI|Upexi, Inc.
URBN|Urban Outfitters, Inc.
URGN|UroGen Pharma Ltd.
URNJ|Sprott Junior Uranium Miners 
UROY|Uranium Royalty Corp.
USAF|Atlas America Fund
USAP|Universal Stainless & Alloy Products, Inc.
USAU|U.S. Gold Corp.
USCB|USCB Financial Holdings, Inc.
USCF|Themes US Cash Flow Champions 
USCL|iShares Climate Conscious & Transition MSCI USA 
USDX|SGI Enhanced Core 
USEA|United Maritime Corporation
USEG|U.S. Energy Corp.
USFI|BrandywineGLOBAL
USGO|U.S. GoldMining Inc.
USGOW|U.S. GoldMining Inc.
USIN|WisdomTree 7
USIO|Usio, Inc.
USLM|United States Lime & Minerals, Inc.
USMC|Principal U.S. Mega
USOY|Defiance Oil Enhanced Options Income 
USRD|Themes US R&D Champions 
USSH|WisdomTree 1
USTB|VictoryShares Short
USVM|VictoryShares US Small Mid Cap Value Momentum 
USXF|iShares ESG Advanced MSCI USA 
UTHR|United Therapeutics Corporation
UTMD|Utah Medical Products, Inc.
UTSI|UTStarcom Holdings Corp
UVSP|Univest Financial Corporation
UXIN|Uxin Limited
VABK|Virginia National Bankshares Corporation
VACH|Voyager Acquisition Corp
VACHU|Voyager Acquisition Corp
VACHW|Voyager Acquisition Corp
VALN|Valneva SE
VALU|Value Line, Inc.
VANI|Vivani Medical, Inc.
VBFC|Village Bank and Trust Financial Corp.
VBNK|VersaBank
VBTX|Veritex Holdings, Inc.
VC|Visteon Corporation
VCEL|Vericel Corporation
VCIC|Vine Hill Capital Investment Corp.
VCICU|Vine Hill Capital Investment Corp.
VCICW|Vine Hill Capital Investment Corp.
VCIG|VCI Global Limited
VCIT|Vanguard Intermediate
VCLT|Vanguard Long
VCNX|Vaccinex, Inc.
VCRB|Vanguard Core Bond 
VCSA|Vacasa, Inc.
VCSH|Vanguard Short
VCTR|Victory Capital Holdings, Inc.
VCYT|Veracyte, Inc.
VECO|Veeco Instruments Inc.
VEEA|Veea Inc.
VEEAW|Veea Inc.
VEEE|Twin Vee PowerCats Co.
VEON|VEON Ltd.
VERA|Vera Therapeutics, Inc.
VERB|Verb Technology Company, Inc.
VERI|Veritone, Inc.
VERO|Venus Concept Inc.
VERU|Veru Inc.
VERV|Verve Therapeutics, Inc.
VERX|Vertex, Inc.
VFF|Village Farms International, Inc.
VFLO|VictoryShares Free Cash Flow 
VFS|VinFast Auto Ltd.
VFSWW|VinFast Auto Ltd.
VGAS|Verde Clean Fuels, Inc.
VGASW|Verde Clean Fuels, Inc.
VGIT|Vanguard Intermediate
VGLT|Vanguard Long
VGSH|Vanguard Short
VGSR|Vert Global Sustainable Real Estate 
VIASP|Via Renewables, Inc.
VIAV|Viavi Solutions Inc.
VICR|Vicor Corporation
VIGI|Vanguard International Dividend Appreciation 
VIGL|Vigil Neuroscience, Inc.
VINC|Vincerx Pharma, Inc.
VINP|Vinci Partners Investments Ltd.
VIOT|Viomi Technology Co., Ltd
VIR|Vir Biotechnology, Inc.
VIRC|Virco Manufacturing Corporation
VIRT|Virtu Financial, Inc.
VIRX|Viracta Therapeutics, Inc.
VISL|Vislink Technologies, Inc.
VITL|Vital Farms, Inc.
VIVK|Vivakor, Inc.
VKTX|Viking Therapeutics, Inc.
VLCN|Volcon, Inc.
VLGEA|Village Super Market, Inc.
VLY|Valley National Bancorp
VLYPN|Valley National Bancorp
VLYPO|Valley National Bancorp
VLYPP|Valley National Bancorp
VMAR|Vision Marine Technologies Inc.
VMBS|Vanguard Mortgage
VMCA|Valuence Merger Corp.
VMCAU|Valuence Merger Corp.
VMCAW|Valuence Merger Corp.
VMD|Viemed Healthcare, Inc.
VMEO|Vimeo, Inc.
VMOT|Alpha Architect Value Momentum Trend 
VNDA|Vanda Pharmaceuticals Inc.
VNET|VNET Group, Inc.
VNOM|Viper Energy, Inc.
VNQI|Vanguard Global ex
VOD|Vodafone Group Plc
VONE|Vanguard Russell 1000 
VONG|Vanguard Russell 1000 Growth 
VONV|Vanguard Russell 1000 Value 
VOR|Vor Biopharma Inc.
VOXR|Vox Royalty Corp.
VOXX|VOXX International Corporation
VPLS|Vanguard Core Plus Bond 
VRA|Vera Bradley, Inc.
VRAR|The Glimpse Group, Inc.
VRAX|Virax Biolabs Group Limited
VRCA|Verrica Pharmaceuticals Inc.
VRDN|Viridian Therapeutics, Inc.
VREX|Varex Imaging Corporation
VRIG|Invesco Variable Rate Investment Grade 
VRM|Vroom, Inc.
VRME|VerifyMe, Inc.
VRMEW|VerifyMe, Inc.
VRNA|Verona Pharma plc
VRNS|Varonis Systems, Inc.
VRNT|Verint Systems Inc.
VRPX|Virpax Pharmaceuticals, Inc.
VRRM|Verra Mobility Corporation
VRSK|Verisk Analytics, Inc.
VRSN|VeriSign, Inc.
VRTX|Vertex Pharmaceuticals Incorporated
VS|Versus Systems Inc.
VSAT|ViaSat, Inc.
VSDA|VictoryShares Dividend Accelerator 
VSEC|VSE Corporation
VSEE|VSee Health, Inc.
VSEEW|VSee Health, Inc.
VSME|VS Media Holdings Limited
VSMV|VictoryShares US Multi
VSSYW|Versus Systems Inc.
VSTA|Vasta Platform Limited
VSTE|Vast Renewables Limited
VSTEW|Vast Renewables Limited
VSTM|Verastem, Inc.
VTGN|Vistagen Therapeutics, Inc.
VTHR|Vanguard Russell 3000 
VTIP|Vanguard Short
VTRS|Viatris Inc.
VTSI|VirTra, Inc.
VTVT|vTv Therapeutics Inc.
VTYX|Ventyx Biosciences, Inc.
VUZI|Vuzix Corporation
VVOS|Vivos Therapeutics, Inc.
VVPR|VivoPower International PLC
VXRT|Vaxart, Inc.
VYGR|Voyager Therapeutics, Inc.
VYMI|Vanguard International
VYNE|VYNE Therapeutics Inc.
WABC|Westamerica Bancorporation
WABF|Western Asset
WAFD|WaFd, Inc.
WAFDP|WaFd, Inc.
WAFU|Wah Fu Education Group Limited
WAI|Top KingWin Ltd
WASH|Washington Trust Bancorp, Inc.
WATT|Energous Corporation
WAVE|Eco Wave Power Global
WAVS|Western Acquisition Ventures Corp.
WAVSU|Western Acquisition Ventures Corp.
WAVSW|Western Acquisition Ventures Corp.
WAY|Waystar Holding Corp.
WB|Weibo Corporation
WBA|Walgreens Boots Alliance, Inc.
WBD|Warner Bros. Discovery, Inc.
WBND|Western Asset Total Return
WBTN|WEBTOON Entertainment Inc.
WBUY|WEBUY GLOBAL LTD.
WCBR|WisdomTree Cybersecurity Fund
WCLD|WisdomTree Cloud Computing Fund
WCT|Wellchange Holdings Company Limited
WDAY|Workday, Inc.
WDC|Western Digital Corporation
WDFC|WD
WEEI|Westwood Salient Enhanced Energy Income
WEN|Wendy's Company
WERN|Werner Enterprises, Inc.
WEST|Westrock Coffee Company
WETH|Wetouch Technology Inc.
WEYS|Weyco Group, Inc.
WFCF|Where Food Comes From, Inc.
WFRD|Weatherford International
WGMI|CoinShares Valkyrie Bitcoin Miners
WGS|GeneDx Holdings Corp.
WGSWW|GeneDx Holdings Corp.
WHF|WhiteHorse Finance, Inc.
WHFCL|WhiteHorse Finance, Inc.
WHLM|Wilhelmina International, Inc.
WHLR|Wheeler Real Estate Investment Trust, Inc.
WHLRD|Wheeler Real Estate Investment Trust, Inc.
WHLRL|Wheeler Real Estate Investment Trust, Inc.
WHLRP|Wheeler Real Estate Investment Trust, Inc.
WILC|G. Willi
WIMI|WiMi Hologram Cloud Inc.
WINA|Winmark Corporation
WINC|Western Asset Short Duration Income
WING|Wingstop Inc.
WINT|Windtree Therapeutics, Inc.
WINV|WinVest Acquisition Corp.
WINVR|WinVest Acquisition Corp.
WINVU|WinVest Acquisition Corp.
WINVW|WinVest Acquisition Corp.
WISA|WiSA Technologies, Inc.
WISE|Themes Generative Artificial Intelligence 
WIX|Wix.com Ltd.
WKEY|WISeKey International Holding Ltd
WKHS|Workhorse Group, Inc.
WKSP|Worksport, Ltd.
WLACU|Willow Lane Acquisition Corp.
WLDN|Willdan Group, Inc.
WLDS|Wearable Devices Ltd.
WLDSW|Wearable Devices Ltd.
WLFC|Willis Lease Finance Corporation
WLGS|Wang & Lee Group, Inc.
WMG|Warner Music Group Corp.
WMPN|William Penn Bancorporation
WNDY|Global X Wind Energy 
WNEB|Western New England Bancorp, Inc.
WNW|Meiwu Technology Company Limited
WOK|WORK Medical Technology Group LTD
WOOD|iShares Global Timber & Forestry 
WOOF|Petco Health and Wellness Company, Inc.
WORX|SCWorx Corp.
WPRT|Westport Fuel Systems Inc
WRAP|Wrap Technologies, Inc.
WRD|WeRide Inc.
WRLD|World Acceptance Corporation
WRND|NYLI Global Equity R&D Leaders 
WSBC|WesBanco, Inc.
WSBCP|WesBanco, Inc.
WSBF|Waterstone Financial, Inc.
WSC|WillScot Holdings Corporation
WSFS|WSFS Financial Corporation
WTBA|West Bancorporation
WTBN|WisdomTree Bianco Total Return Fund
WTFC|Wintrust Financial Corporation
WTFCM|Wintrust Financial Corporation
WTFCP|Wintrust Financial Corporation
WTMA|Welsbach Technology Metals Acquisition Corp.
WTMAR|Welsbach Technology Metals Acquisition Corp.
WTMAU|Welsbach Technology Metals Acquisition Corp.
WTO|UTime Limited
WTW|Willis Towers Watson Public Limited Company
WULF|TeraWulf Inc.
WVE|Wave Life Sciences Ltd.
WVVI|Willamette Valley Vineyards, Inc.
WVVIP|Willamette Valley Vineyards, Inc.
WW|WW International, Inc.
WWD|Woodward, Inc.
WYNN|Wynn Resorts, Limited
XAIR|Beyond Air, Inc.
XAIX|Xtrackers Artificial Intelligence and Big Data 
XBIL|US Treasury 6 Month Bill 
XBIO|Xenetic Biosciences, Inc.
XBIT|XBiotech Inc.
XBP|XBP Europe Holdings, Inc.
XBPEW|XBP Europe Holdings, Inc.
XCH|XCHG Limited
XCNY|SPDR S&P Emerging Markets ex
XCUR|Exicure, Inc.
XEL|Xcel Energy Inc.
XELB|Xcel Brands, Inc
XENE|Xenon Pharmaceuticals Inc.
XERS|Xeris Biopharma Holdings, Inc.
XFIX|F/m Opportunistic Income 
XFOR|X4 Pharmaceuticals, Inc.
XGN|Exagen Inc.
XHG|XChange TEC.INC
XLO|Xilio Therapeutics, Inc.
XMAG|Defiance Large Cap ex
XMTR|Xometry, Inc.
XNCR|Xencor, Inc.
XNET|Xunlei Limited
XOMA|XOMA Royalty Corporation
XOMAO|XOMA Royalty Corporation
XOMAP|XOMA Royalty Corporation
XOS|Xos, Inc.
XOSWW|Xos, Inc.
XOVR|ERShares Private
XP|XP Inc.
XPEL|XPEL, Inc.
XPON|Expion360 Inc.
XRAY|DENTSPLY SIRONA Inc.
XRTX|XORTX Therapeutics Inc.
XRX|Xerox Holdings Corporation
XT|iShares Exponential Technologies 
XTIA|XTI Aerospace, Inc. Common Stock
XTKG|X3 Holdings Co., Ltd.
XTLB|XTL Biopharmaceuticals Ltd.
XWEL|XWELL, Inc.
XXII|22nd Century Group, Inc
XYLO|Xylo Technologies Ltd.
YGMZ|MingZhu Logistics Holdings Limited
YHGJ|Yunhong Green CTI Ltd.
YHNA|YHN Acquisition I Limited
YHNAR|YHN Acquisition I Limited
YHNAU|YHN Acquisition I Limited
YI|111, Inc.
YIBO|Planet Image International Limited
YJ|Yunji Inc.
YLDE|ClearBridge Dividend Strategy ESG 
YMAB|Y
YORW|The York Water Company
YOSH|Yoshiharu Global Co.
YOTA|Yotta Acquisition Corporation
YOTAR|Yotta Acquisition Corporation
YOTAU|Yotta Acquisition Corporation
YOTAW|Yotta Acquisition Corporation
YQ|17 Education & Technology Group Inc.
YQQQ|YieldMax Short N100 Option Income Strategy 
YTRA|Yatra Online, Inc.
YXT|YXT.COM GROUP HOLDING LIMITED
YY|JOYY Inc.
YYAI|Connexa Sports Technologies Inc.
YYGH|YY Group Holding Limited
Z|Zillow Group, Inc.
ZAPP|Zapp Electric Vehicles Group Limited
ZAPPW|Zapp Electric Vehicles Group Limited
ZBAO|Zhibao Technology Inc.
ZBIO|Zenas BioPharma, Inc.
ZBRA|Zebra Technologies Corporation
ZCAR|Zoomcar Holdings, Inc.
ZCARW|Zoomcar Holdings, Inc.
ZCMD|Zhongchao Inc.
ZD|Ziff Davis, Inc.
ZENA|ZenaTech, Inc.
ZENV|Zenvia Inc.
ZEO|Zeo Energy Corporation
ZEOWW|Zeo Energy Corporation
ZEUS|Olympic Steel, Inc.
ZG|Zillow Group, Inc.
ZI|ZoomInfo Technologies Inc.
ZIMV|ZimVie Inc.
ZION|Zions Bancorporation N.A.
ZIONL|Zions Bancorporation N.A.
ZIONO|Zions Bancorporation N.A.
ZIONP|Zions Bancorporation N.A.
ZJK|ZJK Industrial Co., Ltd.
ZJYL|JIN MEDICAL INTERNATIONAL LTD.
ZKIN|ZK International Group Co., Ltd
ZLAB|Zai Lab Limited
ZM|Zoom Video Communications, Inc.
ZNTL|Zentalis Pharmaceuticals, Inc.
ZOOZ|ZOOZ Power Ltd.
ZOOZW|ZOOZ Power Ltd.
ZS|Zscaler, Inc.
ZTEK|Zentek Ltd.
ZUMZ|Zumiez Inc.
ZURA|Zura Bio Limited
ZVRA|Zevra Therapeutics, Inc.
ZVSA|ZyVersa Therapeutics, Inc.
ZYME|Zymeworks Inc.
ZYXI|Zynex, Inc.
ZZZ|Cyber Hornet S&P 500 and Bitcoin 75/25 Strategy 
